#SampleID	BarcodeSequence	LinkerPrimerSequence	Description
Amsterdam.A.1	TCGCCTTATAGATCGC	ACTCCTRCGGGAGGCAGCAG	Amsterdam.A.1
Amsterdam.A.10	TTCTGCCTTGAACCTT	ACTCCTRCGGGAGGCAGCAG	Amsterdam.A.10
Amsterdam.A.11	TTCTGCCTTATAGCCT	ACTCCTRCGGGAGGCAGCAG	Amsterdam.A.11
Amsterdam.A.12	TTCTGCCTCGTCTAAT	ACTCCTRCGGGAGGCAGCAG	Amsterdam.A.12
Amsterdam.A.2	TCGCCTTATGAACCTT	ACTCCTRCGGGAGGCAGCAG	Amsterdam.A.2
Amsterdam.A.3	TCGCCTTATATAGCCT	ACTCCTRCGGGAGGCAGCAG	Amsterdam.A.3
Amsterdam.A.4	TCGCCTTACGTCTAAT	ACTCCTRCGGGAGGCAGCAG	Amsterdam.A.4
Amsterdam.A.5	CTAGTACGTAGATCGC	ACTCCTRCGGGAGGCAGCAG	Amsterdam.A.5
Amsterdam.A.6	CTAGTACGTGAACCTT	ACTCCTRCGGGAGGCAGCAG	Amsterdam.A.6
Amsterdam.A.7	CTAGTACGTATAGCCT	ACTCCTRCGGGAGGCAGCAG	Amsterdam.A.7
Amsterdam.A.8	CTAGTACGCGTCTAAT	ACTCCTRCGGGAGGCAGCAG	Amsterdam.A.8
Amsterdam.A.9	TTCTGCCTTAGATCGC	ACTCCTRCGGGAGGCAGCAG	Amsterdam.A.9
Amsterdam.B.1	TCGCCTTACTCTCTAT	ACTCCTRCGGGAGGCAGCAG	Amsterdam.B.1
Amsterdam.B.10	TTCTGCCTTGCTAAGT	ACTCCTRCGGGAGGCAGCAG	Amsterdam.B.10
Amsterdam.B.11	TTCTGCCTATAGAGGC	ACTCCTRCGGGAGGCAGCAG	Amsterdam.B.11
Amsterdam.B.12	TTCTGCCTTCTCTCCG	ACTCCTRCGGGAGGCAGCAG	Amsterdam.B.12
Amsterdam.B.2	TCGCCTTATGCTAAGT	ACTCCTRCGGGAGGCAGCAG	Amsterdam.B.2
Amsterdam.B.3	TCGCCTTAATAGAGGC	ACTCCTRCGGGAGGCAGCAG	Amsterdam.B.3
Amsterdam.B.4	TCGCCTTATCTCTCCG	ACTCCTRCGGGAGGCAGCAG	Amsterdam.B.4
Amsterdam.B.5	CTAGTACGCTCTCTAT	ACTCCTRCGGGAGGCAGCAG	Amsterdam.B.5
Amsterdam.B.6	CTAGTACGTGCTAAGT	ACTCCTRCGGGAGGCAGCAG	Amsterdam.B.6
Amsterdam.B.7	CTAGTACGATAGAGGC	ACTCCTRCGGGAGGCAGCAG	Amsterdam.B.7
Amsterdam.B.8	CTAGTACGTCTCTCCG	ACTCCTRCGGGAGGCAGCAG	Amsterdam.B.8
Amsterdam.B.9	TTCTGCCTCTCTCTAT	ACTCCTRCGGGAGGCAGCAG	Amsterdam.B.9
Amsterdam.C.1	TCGCCTTATATCCTCT	ACTCCTRCGGGAGGCAGCAG	Amsterdam.C.1
Amsterdam.C.10	TTCTGCCTTGTTCTCT	ACTCCTRCGGGAGGCAGCAG	Amsterdam.C.10
Amsterdam.C.11	TTCTGCCTCCTATCCT	ACTCCTRCGGGAGGCAGCAG	Amsterdam.C.11
Amsterdam.C.12	TTCTGCCTTCGACTAG	ACTCCTRCGGGAGGCAGCAG	Amsterdam.C.12
Amsterdam.C.2	TCGCCTTATGTTCTCT	ACTCCTRCGGGAGGCAGCAG	Amsterdam.C.2
Amsterdam.C.3	TCGCCTTACCTATCCT	ACTCCTRCGGGAGGCAGCAG	Amsterdam.C.3
Amsterdam.C.4	TCGCCTTATCGACTAG	ACTCCTRCGGGAGGCAGCAG	Amsterdam.C.4
Amsterdam.C.5	CTAGTACGTATCCTCT	ACTCCTRCGGGAGGCAGCAG	Amsterdam.C.5
Amsterdam.C.6	CTAGTACGTGTTCTCT	ACTCCTRCGGGAGGCAGCAG	Amsterdam.C.6
Amsterdam.C.7	CTAGTACGCCTATCCT	ACTCCTRCGGGAGGCAGCAG	Amsterdam.C.7
Amsterdam.C.8	CTAGTACGTCGACTAG	ACTCCTRCGGGAGGCAGCAG	Amsterdam.C.8
Amsterdam.C.9	TTCTGCCTTATCCTCT	ACTCCTRCGGGAGGCAGCAG	Amsterdam.C.9
Amsterdam.D.1	TCGCCTTAAGAGTAGA	ACTCCTRCGGGAGGCAGCAG	Amsterdam.D.1
Amsterdam.D.10	TTCTGCCTTAAGACAC	ACTCCTRCGGGAGGCAGCAG	Amsterdam.D.10
Amsterdam.D.11	TTCTGCCTGGCTCTGA	ACTCCTRCGGGAGGCAGCAG	Amsterdam.D.11
Amsterdam.D.12	TTCTGCCTTTCTAGCT	ACTCCTRCGGGAGGCAGCAG	Amsterdam.D.12
Amsterdam.D.2	TCGCCTTATAAGACAC	ACTCCTRCGGGAGGCAGCAG	Amsterdam.D.2
Amsterdam.D.3	TCGCCTTAGGCTCTGA	ACTCCTRCGGGAGGCAGCAG	Amsterdam.D.3
Amsterdam.D.4	TCGCCTTATTCTAGCT	ACTCCTRCGGGAGGCAGCAG	Amsterdam.D.4
Amsterdam.D.5	CTAGTACGAGAGTAGA	ACTCCTRCGGGAGGCAGCAG	Amsterdam.D.5
Amsterdam.D.6	CTAGTACGTAAGACAC	ACTCCTRCGGGAGGCAGCAG	Amsterdam.D.6
Amsterdam.D.7	CTAGTACGGGCTCTGA	ACTCCTRCGGGAGGCAGCAG	Amsterdam.D.7
Amsterdam.D.8	CTAGTACGTTCTAGCT	ACTCCTRCGGGAGGCAGCAG	Amsterdam.D.8
Amsterdam.D.9	TTCTGCCTAGAGTAGA	ACTCCTRCGGGAGGCAGCAG	Amsterdam.D.9
Amsterdam.E.1	TCGCCTTAGTAAGGAG	ACTCCTRCGGGAGGCAGCAG	Amsterdam.E.1
Amsterdam.E.10	TTCTGCCTCTAATCGA	ACTCCTRCGGGAGGCAGCAG	Amsterdam.E.10
Amsterdam.E.11	TTCTGCCTAGGCGAAG	ACTCCTRCGGGAGGCAGCAG	Amsterdam.E.11
Amsterdam.E.12	TTCTGCCTCCTAGAGT	ACTCCTRCGGGAGGCAGCAG	Amsterdam.E.12
Amsterdam.E.2	TCGCCTTACTAATCGA	ACTCCTRCGGGAGGCAGCAG	Amsterdam.E.2
Amsterdam.E.3	TCGCCTTAAGGCGAAG	ACTCCTRCGGGAGGCAGCAG	Amsterdam.E.3
Amsterdam.E.4	TCGCCTTACCTAGAGT	ACTCCTRCGGGAGGCAGCAG	Amsterdam.E.4
Amsterdam.E.5	CTAGTACGGTAAGGAG	ACTCCTRCGGGAGGCAGCAG	Amsterdam.E.5
Amsterdam.E.6	CTAGTACGCTAATCGA	ACTCCTRCGGGAGGCAGCAG	Amsterdam.E.6
Amsterdam.E.7	CTAGTACGAGGCGAAG	ACTCCTRCGGGAGGCAGCAG	Amsterdam.E.7
Amsterdam.E.8	CTAGTACGCCTAGAGT	ACTCCTRCGGGAGGCAGCAG	Amsterdam.E.8
Amsterdam.E.9	TTCTGCCTGTAAGGAG	ACTCCTRCGGGAGGCAGCAG	Amsterdam.E.9
Amsterdam.F.1	TCGCCTTAACTGCATA	ACTCCTRCGGGAGGCAGCAG	Amsterdam.F.1
Amsterdam.F.10	TTCTGCCTCTAGAACA	ACTCCTRCGGGAGGCAGCAG	Amsterdam.F.10
Amsterdam.F.11	TTCTGCCTTAATCTTA	ACTCCTRCGGGAGGCAGCAG	Amsterdam.F.11
Amsterdam.F.12	TTCTGCCTCTATTAAG	ACTCCTRCGGGAGGCAGCAG	Amsterdam.F.12
Amsterdam.F.2	TCGCCTTACTAGAACA	ACTCCTRCGGGAGGCAGCAG	Amsterdam.F.2
Amsterdam.F.3	TCGCCTTATAATCTTA	ACTCCTRCGGGAGGCAGCAG	Amsterdam.F.3
Amsterdam.F.4	TCGCCTTACTATTAAG	ACTCCTRCGGGAGGCAGCAG	Amsterdam.F.4
Amsterdam.F.5	CTAGTACGACTGCATA	ACTCCTRCGGGAGGCAGCAG	Amsterdam.F.5
Amsterdam.F.6	CTAGTACGCTAGAACA	ACTCCTRCGGGAGGCAGCAG	Amsterdam.F.6
Amsterdam.F.7	CTAGTACGTAATCTTA	ACTCCTRCGGGAGGCAGCAG	Amsterdam.F.7
Amsterdam.F.8	CTAGTACGCTATTAAG	ACTCCTRCGGGAGGCAGCAG	Amsterdam.F.8
Amsterdam.F.9	TTCTGCCTACTGCATA	ACTCCTRCGGGAGGCAGCAG	Amsterdam.F.9
Amsterdam.G.1	TCGCCTTAAAGGAGTA	ACTCCTRCGGGAGGCAGCAG	Amsterdam.G.1
Amsterdam.G.10	TTCTGCCTTAAGTTCC	ACTCCTRCGGGAGGCAGCAG	Amsterdam.G.10
Amsterdam.G.11	TTCTGCCTCAGGACGT	ACTCCTRCGGGAGGCAGCAG	Amsterdam.G.11
Amsterdam.G.12	TTCTGCCTAAGGCTAT	ACTCCTRCGGGAGGCAGCAG	Amsterdam.G.12
Amsterdam.G.2	TCGCCTTATAAGTTCC	ACTCCTRCGGGAGGCAGCAG	Amsterdam.G.2
Amsterdam.G.3	TCGCCTTACAGGACGT	ACTCCTRCGGGAGGCAGCAG	Amsterdam.G.3
Amsterdam.G.4	TCGCCTTAAAGGCTAT	ACTCCTRCGGGAGGCAGCAG	Amsterdam.G.4
Amsterdam.G.5	CTAGTACGAAGGAGTA	ACTCCTRCGGGAGGCAGCAG	Amsterdam.G.5
Amsterdam.G.6	CTAGTACGTAAGTTCC	ACTCCTRCGGGAGGCAGCAG	Amsterdam.G.6
Amsterdam.G.7	CTAGTACGCAGGACGT	ACTCCTRCGGGAGGCAGCAG	Amsterdam.G.7
Amsterdam.G.8	CTAGTACGAAGGCTAT	ACTCCTRCGGGAGGCAGCAG	Amsterdam.G.8
Amsterdam.G.9	TTCTGCCTAAGGAGTA	ACTCCTRCGGGAGGCAGCAG	Amsterdam.G.9
Amsterdam.H.1	TCGCCTTACTAAGCCT	ACTCCTRCGGGAGGCAGCAG	Amsterdam.H.1
Amsterdam.H.10	TTCTGCCTTAGACCTA	ACTCCTRCGGGAGGCAGCAG	Amsterdam.H.10
Amsterdam.H.11	TTCTGCCTGTACTGAC	ACTCCTRCGGGAGGCAGCAG	Amsterdam.H.11
Amsterdam.H.12	TTCTGCCTGAGCCTTA	ACTCCTRCGGGAGGCAGCAG	Amsterdam.H.12
Amsterdam.H.2	TCGCCTTATAGACCTA	ACTCCTRCGGGAGGCAGCAG	Amsterdam.H.2
Amsterdam.H.3	TCGCCTTAGTACTGAC	ACTCCTRCGGGAGGCAGCAG	Amsterdam.H.3
Amsterdam.H.4	TCGCCTTAGAGCCTTA	ACTCCTRCGGGAGGCAGCAG	Amsterdam.H.4
Amsterdam.H.5	CTAGTACGCTAAGCCT	ACTCCTRCGGGAGGCAGCAG	Amsterdam.H.5
Amsterdam.H.6	CTAGTACGTAGACCTA	ACTCCTRCGGGAGGCAGCAG	Amsterdam.H.6
Amsterdam.H.7	CTAGTACGGTACTGAC	ACTCCTRCGGGAGGCAGCAG	Amsterdam.H.7
Amsterdam.H.8	CTAGTACGGAGCCTTA	ACTCCTRCGGGAGGCAGCAG	Amsterdam.H.8
Amsterdam.H.9	TTCTGCCTCTAAGCCT	ACTCCTRCGGGAGGCAGCAG	Amsterdam.H.9
Beijing.A.1	GCTCAGGATAGATCGC	ACTCCTRCGGGAGGCAGCAG	Beijing.A.1
Beijing.A.10	CATGCCTATGAACCTT	ACTCCTRCGGGAGGCAGCAG	Beijing.A.10
Beijing.A.11	CATGCCTATATAGCCT	ACTCCTRCGGGAGGCAGCAG	Beijing.A.11
Beijing.A.12	CATGCCTACGTCTAAT	ACTCCTRCGGGAGGCAGCAG	Beijing.A.12
Beijing.A.2	GCTCAGGATGAACCTT	ACTCCTRCGGGAGGCAGCAG	Beijing.A.2
Beijing.A.3	GCTCAGGATATAGCCT	ACTCCTRCGGGAGGCAGCAG	Beijing.A.3
Beijing.A.4	GCTCAGGACGTCTAAT	ACTCCTRCGGGAGGCAGCAG	Beijing.A.4
Beijing.A.5	AGGAGTCCTAGATCGC	ACTCCTRCGGGAGGCAGCAG	Beijing.A.5
Beijing.A.6	AGGAGTCCTGAACCTT	ACTCCTRCGGGAGGCAGCAG	Beijing.A.6
Beijing.A.7	AGGAGTCCTATAGCCT	ACTCCTRCGGGAGGCAGCAG	Beijing.A.7
Beijing.A.8	AGGAGTCCCGTCTAAT	ACTCCTRCGGGAGGCAGCAG	Beijing.A.8
Beijing.A.9	CATGCCTATAGATCGC	ACTCCTRCGGGAGGCAGCAG	Beijing.A.9
Beijing.B.1	GCTCAGGACTCTCTAT	ACTCCTRCGGGAGGCAGCAG	Beijing.B.1
Beijing.B.10	CATGCCTATGCTAAGT	ACTCCTRCGGGAGGCAGCAG	Beijing.B.10
Beijing.B.11	CATGCCTAATAGAGGC	ACTCCTRCGGGAGGCAGCAG	Beijing.B.11
Beijing.B.12	CATGCCTATCTCTCCG	ACTCCTRCGGGAGGCAGCAG	Beijing.B.12
Beijing.B.2	GCTCAGGATGCTAAGT	ACTCCTRCGGGAGGCAGCAG	Beijing.B.2
Beijing.B.3	GCTCAGGAATAGAGGC	ACTCCTRCGGGAGGCAGCAG	Beijing.B.3
Beijing.B.4	GCTCAGGATCTCTCCG	ACTCCTRCGGGAGGCAGCAG	Beijing.B.4
Beijing.B.5	AGGAGTCCCTCTCTAT	ACTCCTRCGGGAGGCAGCAG	Beijing.B.5
Beijing.B.6	AGGAGTCCTGCTAAGT	ACTCCTRCGGGAGGCAGCAG	Beijing.B.6
Beijing.B.7	AGGAGTCCATAGAGGC	ACTCCTRCGGGAGGCAGCAG	Beijing.B.7
Beijing.B.8	AGGAGTCCTCTCTCCG	ACTCCTRCGGGAGGCAGCAG	Beijing.B.8
Beijing.B.9	CATGCCTACTCTCTAT	ACTCCTRCGGGAGGCAGCAG	Beijing.B.9
Beijing.C.1	GCTCAGGATATCCTCT	ACTCCTRCGGGAGGCAGCAG	Beijing.C.1
Beijing.C.10	CATGCCTATGTTCTCT	ACTCCTRCGGGAGGCAGCAG	Beijing.C.10
Beijing.C.11	CATGCCTACCTATCCT	ACTCCTRCGGGAGGCAGCAG	Beijing.C.11
Beijing.C.12	CATGCCTATCGACTAG	ACTCCTRCGGGAGGCAGCAG	Beijing.C.12
Beijing.C.2	GCTCAGGATGTTCTCT	ACTCCTRCGGGAGGCAGCAG	Beijing.C.2
Beijing.C.3	GCTCAGGACCTATCCT	ACTCCTRCGGGAGGCAGCAG	Beijing.C.3
Beijing.C.4	GCTCAGGATCGACTAG	ACTCCTRCGGGAGGCAGCAG	Beijing.C.4
Beijing.C.5	AGGAGTCCTATCCTCT	ACTCCTRCGGGAGGCAGCAG	Beijing.C.5
Beijing.C.6	AGGAGTCCTGTTCTCT	ACTCCTRCGGGAGGCAGCAG	Beijing.C.6
Beijing.C.7	AGGAGTCCCCTATCCT	ACTCCTRCGGGAGGCAGCAG	Beijing.C.7
Beijing.C.8	AGGAGTCCTCGACTAG	ACTCCTRCGGGAGGCAGCAG	Beijing.C.8
Beijing.C.9	CATGCCTATATCCTCT	ACTCCTRCGGGAGGCAGCAG	Beijing.C.9
Beijing.D.1	GCTCAGGAAGAGTAGA	ACTCCTRCGGGAGGCAGCAG	Beijing.D.1
Beijing.D.10	CATGCCTATAAGACAC	ACTCCTRCGGGAGGCAGCAG	Beijing.D.10
Beijing.D.11	CATGCCTAGGCTCTGA	ACTCCTRCGGGAGGCAGCAG	Beijing.D.11
Beijing.D.12	CATGCCTATTCTAGCT	ACTCCTRCGGGAGGCAGCAG	Beijing.D.12
Beijing.D.2	GCTCAGGATAAGACAC	ACTCCTRCGGGAGGCAGCAG	Beijing.D.2
Beijing.D.3	GCTCAGGAGGCTCTGA	ACTCCTRCGGGAGGCAGCAG	Beijing.D.3
Beijing.D.4	GCTCAGGATTCTAGCT	ACTCCTRCGGGAGGCAGCAG	Beijing.D.4
Beijing.D.5	AGGAGTCCAGAGTAGA	ACTCCTRCGGGAGGCAGCAG	Beijing.D.5
Beijing.D.6	AGGAGTCCTAAGACAC	ACTCCTRCGGGAGGCAGCAG	Beijing.D.6
Beijing.D.7	AGGAGTCCGGCTCTGA	ACTCCTRCGGGAGGCAGCAG	Beijing.D.7
Beijing.D.8	AGGAGTCCTTCTAGCT	ACTCCTRCGGGAGGCAGCAG	Beijing.D.8
Beijing.D.9	CATGCCTAAGAGTAGA	ACTCCTRCGGGAGGCAGCAG	Beijing.D.9
Beijing.E.1	GCTCAGGAGTAAGGAG	ACTCCTRCGGGAGGCAGCAG	Beijing.E.1
Beijing.E.10	CATGCCTACTAATCGA	ACTCCTRCGGGAGGCAGCAG	Beijing.E.10
Beijing.E.11	CATGCCTAAGGCGAAG	ACTCCTRCGGGAGGCAGCAG	Beijing.E.11
Beijing.E.12	CATGCCTACCTAGAGT	ACTCCTRCGGGAGGCAGCAG	Beijing.E.12
Beijing.E.2	GCTCAGGACTAATCGA	ACTCCTRCGGGAGGCAGCAG	Beijing.E.2
Beijing.E.3	GCTCAGGAAGGCGAAG	ACTCCTRCGGGAGGCAGCAG	Beijing.E.3
Beijing.E.4	GCTCAGGACCTAGAGT	ACTCCTRCGGGAGGCAGCAG	Beijing.E.4
Beijing.E.5	AGGAGTCCGTAAGGAG	ACTCCTRCGGGAGGCAGCAG	Beijing.E.5
Beijing.E.6	AGGAGTCCCTAATCGA	ACTCCTRCGGGAGGCAGCAG	Beijing.E.6
Beijing.E.7	AGGAGTCCAGGCGAAG	ACTCCTRCGGGAGGCAGCAG	Beijing.E.7
Beijing.E.8	AGGAGTCCCCTAGAGT	ACTCCTRCGGGAGGCAGCAG	Beijing.E.8
Beijing.E.9	CATGCCTAGTAAGGAG	ACTCCTRCGGGAGGCAGCAG	Beijing.E.9
Beijing.F.1	GCTCAGGAACTGCATA	ACTCCTRCGGGAGGCAGCAG	Beijing.F.1
Beijing.F.10	CATGCCTACTAGAACA	ACTCCTRCGGGAGGCAGCAG	Beijing.F.10
Beijing.F.11	CATGCCTATAATCTTA	ACTCCTRCGGGAGGCAGCAG	Beijing.F.11
Beijing.F.12	CATGCCTACTATTAAG	ACTCCTRCGGGAGGCAGCAG	Beijing.F.12
Beijing.F.2	GCTCAGGACTAGAACA	ACTCCTRCGGGAGGCAGCAG	Beijing.F.2
Beijing.F.3	GCTCAGGATAATCTTA	ACTCCTRCGGGAGGCAGCAG	Beijing.F.3
Beijing.F.4	GCTCAGGACTATTAAG	ACTCCTRCGGGAGGCAGCAG	Beijing.F.4
Beijing.F.5	AGGAGTCCACTGCATA	ACTCCTRCGGGAGGCAGCAG	Beijing.F.5
Beijing.F.6	AGGAGTCCCTAGAACA	ACTCCTRCGGGAGGCAGCAG	Beijing.F.6
Beijing.F.7	AGGAGTCCTAATCTTA	ACTCCTRCGGGAGGCAGCAG	Beijing.F.7
Beijing.F.8	AGGAGTCCCTATTAAG	ACTCCTRCGGGAGGCAGCAG	Beijing.F.8
Beijing.F.9	CATGCCTAACTGCATA	ACTCCTRCGGGAGGCAGCAG	Beijing.F.9
Beijing.G.1	GCTCAGGAAAGGAGTA	ACTCCTRCGGGAGGCAGCAG	Beijing.G.1
Beijing.G.10	CATGCCTATAAGTTCC	ACTCCTRCGGGAGGCAGCAG	Beijing.G.10
Beijing.G.11	CATGCCTACAGGACGT	ACTCCTRCGGGAGGCAGCAG	Beijing.G.11
Beijing.G.12	CATGCCTAAAGGCTAT	ACTCCTRCGGGAGGCAGCAG	Beijing.G.12
Beijing.G.2	GCTCAGGATAAGTTCC	ACTCCTRCGGGAGGCAGCAG	Beijing.G.2
Beijing.G.3	GCTCAGGACAGGACGT	ACTCCTRCGGGAGGCAGCAG	Beijing.G.3
Beijing.G.4	GCTCAGGAAAGGCTAT	ACTCCTRCGGGAGGCAGCAG	Beijing.G.4
Beijing.G.5	AGGAGTCCAAGGAGTA	ACTCCTRCGGGAGGCAGCAG	Beijing.G.5
Beijing.G.6	AGGAGTCCTAAGTTCC	ACTCCTRCGGGAGGCAGCAG	Beijing.G.6
Beijing.G.7	AGGAGTCCCAGGACGT	ACTCCTRCGGGAGGCAGCAG	Beijing.G.7
Beijing.G.8	AGGAGTCCAAGGCTAT	ACTCCTRCGGGAGGCAGCAG	Beijing.G.8
Beijing.G.9	CATGCCTAAAGGAGTA	ACTCCTRCGGGAGGCAGCAG	Beijing.G.9
Beijing.H.1	GCTCAGGACTAAGCCT	ACTCCTRCGGGAGGCAGCAG	Beijing.H.1
Beijing.H.10	CATGCCTATAGACCTA	ACTCCTRCGGGAGGCAGCAG	Beijing.H.10
Beijing.H.11	CATGCCTAGTACTGAC	ACTCCTRCGGGAGGCAGCAG	Beijing.H.11
Beijing.H.12	CATGCCTAGAGCCTTA	ACTCCTRCGGGAGGCAGCAG	Beijing.H.12
Beijing.H.2	GCTCAGGATAGACCTA	ACTCCTRCGGGAGGCAGCAG	Beijing.H.2
Beijing.H.3	GCTCAGGAGTACTGAC	ACTCCTRCGGGAGGCAGCAG	Beijing.H.3
Beijing.H.4	GCTCAGGAGAGCCTTA	ACTCCTRCGGGAGGCAGCAG	Beijing.H.4
Beijing.H.5	AGGAGTCCCTAAGCCT	ACTCCTRCGGGAGGCAGCAG	Beijing.H.5
Beijing.H.6	AGGAGTCCTAGACCTA	ACTCCTRCGGGAGGCAGCAG	Beijing.H.6
Beijing.H.7	AGGAGTCCGTACTGAC	ACTCCTRCGGGAGGCAGCAG	Beijing.H.7
Beijing.H.8	AGGAGTCCGAGCCTTA	ACTCCTRCGGGAGGCAGCAG	Beijing.H.8
Beijing.H.9	CATGCCTACTAAGCCT	ACTCCTRCGGGAGGCAGCAG	Beijing.H.9
Chicago.A.1	GTAGAGAGTAGATCGC	ACTCCTRCGGGAGGCAGCAG	Chicago.A.1
Chicago.A.10	AGCGTAGCTGAACCTT	ACTCCTRCGGGAGGCAGCAG	Chicago.A.10
Chicago.A.11	AGCGTAGCTATAGCCT	ACTCCTRCGGGAGGCAGCAG	Chicago.A.11
Chicago.A.12	AGCGTAGCCGTCTAAT	ACTCCTRCGGGAGGCAGCAG	Chicago.A.12
Chicago.A.2	GTAGAGAGTGAACCTT	ACTCCTRCGGGAGGCAGCAG	Chicago.A.2
Chicago.A.3	GTAGAGAGTATAGCCT	ACTCCTRCGGGAGGCAGCAG	Chicago.A.3
Chicago.A.4	GTAGAGAGCGTCTAAT	ACTCCTRCGGGAGGCAGCAG	Chicago.A.4
Chicago.A.5	CCTCTCTGTAGATCGC	ACTCCTRCGGGAGGCAGCAG	Chicago.A.5
Chicago.A.6	CCTCTCTGTGAACCTT	ACTCCTRCGGGAGGCAGCAG	Chicago.A.6
Chicago.A.7	CCTCTCTGTATAGCCT	ACTCCTRCGGGAGGCAGCAG	Chicago.A.7
Chicago.A.8	CCTCTCTGCGTCTAAT	ACTCCTRCGGGAGGCAGCAG	Chicago.A.8
Chicago.A.9	AGCGTAGCTAGATCGC	ACTCCTRCGGGAGGCAGCAG	Chicago.A.9
Chicago.B.1	GTAGAGAGCTCTCTAT	ACTCCTRCGGGAGGCAGCAG	Chicago.B.1
Chicago.B.10	AGCGTAGCTGCTAAGT	ACTCCTRCGGGAGGCAGCAG	Chicago.B.10
Chicago.B.11	AGCGTAGCATAGAGGC	ACTCCTRCGGGAGGCAGCAG	Chicago.B.11
Chicago.B.12	AGCGTAGCTCTCTCCG	ACTCCTRCGGGAGGCAGCAG	Chicago.B.12
Chicago.B.2	GTAGAGAGTGCTAAGT	ACTCCTRCGGGAGGCAGCAG	Chicago.B.2
Chicago.B.3	GTAGAGAGATAGAGGC	ACTCCTRCGGGAGGCAGCAG	Chicago.B.3
Chicago.B.4	GTAGAGAGTCTCTCCG	ACTCCTRCGGGAGGCAGCAG	Chicago.B.4
Chicago.B.5	CCTCTCTGCTCTCTAT	ACTCCTRCGGGAGGCAGCAG	Chicago.B.5
Chicago.B.6	CCTCTCTGTGCTAAGT	ACTCCTRCGGGAGGCAGCAG	Chicago.B.6
Chicago.B.7	CCTCTCTGATAGAGGC	ACTCCTRCGGGAGGCAGCAG	Chicago.B.7
Chicago.B.8	CCTCTCTGTCTCTCCG	ACTCCTRCGGGAGGCAGCAG	Chicago.B.8
Chicago.B.9	AGCGTAGCCTCTCTAT	ACTCCTRCGGGAGGCAGCAG	Chicago.B.9
Chicago.C.1	GTAGAGAGTATCCTCT	ACTCCTRCGGGAGGCAGCAG	Chicago.C.1
Chicago.C.10	AGCGTAGCTGTTCTCT	ACTCCTRCGGGAGGCAGCAG	Chicago.C.10
Chicago.C.11	AGCGTAGCCCTATCCT	ACTCCTRCGGGAGGCAGCAG	Chicago.C.11
Chicago.C.12	AGCGTAGCTCGACTAG	ACTCCTRCGGGAGGCAGCAG	Chicago.C.12
Chicago.C.2	GTAGAGAGTGTTCTCT	ACTCCTRCGGGAGGCAGCAG	Chicago.C.2
Chicago.C.3	GTAGAGAGCCTATCCT	ACTCCTRCGGGAGGCAGCAG	Chicago.C.3
Chicago.C.4	GTAGAGAGTCGACTAG	ACTCCTRCGGGAGGCAGCAG	Chicago.C.4
Chicago.C.5	CCTCTCTGTATCCTCT	ACTCCTRCGGGAGGCAGCAG	Chicago.C.5
Chicago.C.6	CCTCTCTGTGTTCTCT	ACTCCTRCGGGAGGCAGCAG	Chicago.C.6
Chicago.C.7	CCTCTCTGCCTATCCT	ACTCCTRCGGGAGGCAGCAG	Chicago.C.7
Chicago.C.8	CCTCTCTGTCGACTAG	ACTCCTRCGGGAGGCAGCAG	Chicago.C.8
Chicago.C.9	AGCGTAGCTATCCTCT	ACTCCTRCGGGAGGCAGCAG	Chicago.C.9
Chicago.D.1	GTAGAGAGAGAGTAGA	ACTCCTRCGGGAGGCAGCAG	Chicago.D.1
Chicago.D.10	AGCGTAGCTAAGACAC	ACTCCTRCGGGAGGCAGCAG	Chicago.D.10
Chicago.D.11	AGCGTAGCGGCTCTGA	ACTCCTRCGGGAGGCAGCAG	Chicago.D.11
Chicago.D.12	AGCGTAGCTTCTAGCT	ACTCCTRCGGGAGGCAGCAG	Chicago.D.12
Chicago.D.2	GTAGAGAGTAAGACAC	ACTCCTRCGGGAGGCAGCAG	Chicago.D.2
Chicago.D.3	GTAGAGAGGGCTCTGA	ACTCCTRCGGGAGGCAGCAG	Chicago.D.3
Chicago.D.4	GTAGAGAGTTCTAGCT	ACTCCTRCGGGAGGCAGCAG	Chicago.D.4
Chicago.D.5	CCTCTCTGAGAGTAGA	ACTCCTRCGGGAGGCAGCAG	Chicago.D.5
Chicago.D.6	CCTCTCTGTAAGACAC	ACTCCTRCGGGAGGCAGCAG	Chicago.D.6
Chicago.D.7	CCTCTCTGGGCTCTGA	ACTCCTRCGGGAGGCAGCAG	Chicago.D.7
Chicago.D.8	CCTCTCTGTTCTAGCT	ACTCCTRCGGGAGGCAGCAG	Chicago.D.8
Chicago.D.9	AGCGTAGCAGAGTAGA	ACTCCTRCGGGAGGCAGCAG	Chicago.D.9
Chicago.E.1	GTAGAGAGGTAAGGAG	ACTCCTRCGGGAGGCAGCAG	Chicago.E.1
Chicago.E.10	AGCGTAGCCTAATCGA	ACTCCTRCGGGAGGCAGCAG	Chicago.E.10
Chicago.E.11	AGCGTAGCAGGCGAAG	ACTCCTRCGGGAGGCAGCAG	Chicago.E.11
Chicago.E.12	AGCGTAGCCCTAGAGT	ACTCCTRCGGGAGGCAGCAG	Chicago.E.12
Chicago.E.2	GTAGAGAGCTAATCGA	ACTCCTRCGGGAGGCAGCAG	Chicago.E.2
Chicago.E.3	GTAGAGAGAGGCGAAG	ACTCCTRCGGGAGGCAGCAG	Chicago.E.3
Chicago.E.4	GTAGAGAGCCTAGAGT	ACTCCTRCGGGAGGCAGCAG	Chicago.E.4
Chicago.E.5	CCTCTCTGGTAAGGAG	ACTCCTRCGGGAGGCAGCAG	Chicago.E.5
Chicago.E.6	CCTCTCTGCTAATCGA	ACTCCTRCGGGAGGCAGCAG	Chicago.E.6
Chicago.E.7	CCTCTCTGAGGCGAAG	ACTCCTRCGGGAGGCAGCAG	Chicago.E.7
Chicago.E.8	CCTCTCTGCCTAGAGT	ACTCCTRCGGGAGGCAGCAG	Chicago.E.8
Chicago.E.9	AGCGTAGCGTAAGGAG	ACTCCTRCGGGAGGCAGCAG	Chicago.E.9
Chicago.F.1	GTAGAGAGACTGCATA	ACTCCTRCGGGAGGCAGCAG	Chicago.F.1
Chicago.F.10	AGCGTAGCCTAGAACA	ACTCCTRCGGGAGGCAGCAG	Chicago.F.10
Chicago.F.11	AGCGTAGCTAATCTTA	ACTCCTRCGGGAGGCAGCAG	Chicago.F.11
Chicago.F.12	AGCGTAGCCTATTAAG	ACTCCTRCGGGAGGCAGCAG	Chicago.F.12
Chicago.F.2	GTAGAGAGCTAGAACA	ACTCCTRCGGGAGGCAGCAG	Chicago.F.2
Chicago.F.3	GTAGAGAGTAATCTTA	ACTCCTRCGGGAGGCAGCAG	Chicago.F.3
Chicago.F.4	GTAGAGAGCTATTAAG	ACTCCTRCGGGAGGCAGCAG	Chicago.F.4
Chicago.F.5	CCTCTCTGACTGCATA	ACTCCTRCGGGAGGCAGCAG	Chicago.F.5
Chicago.F.6	CCTCTCTGCTAGAACA	ACTCCTRCGGGAGGCAGCAG	Chicago.F.6
Chicago.F.7	CCTCTCTGTAATCTTA	ACTCCTRCGGGAGGCAGCAG	Chicago.F.7
Chicago.F.8	CCTCTCTGCTATTAAG	ACTCCTRCGGGAGGCAGCAG	Chicago.F.8
Chicago.F.9	AGCGTAGCACTGCATA	ACTCCTRCGGGAGGCAGCAG	Chicago.F.9
Chicago.G.1	GTAGAGAGAAGGAGTA	ACTCCTRCGGGAGGCAGCAG	Chicago.G.1
Chicago.G.10	AGCGTAGCTAAGTTCC	ACTCCTRCGGGAGGCAGCAG	Chicago.G.10
Chicago.G.11	AGCGTAGCCAGGACGT	ACTCCTRCGGGAGGCAGCAG	Chicago.G.11
Chicago.G.12	AGCGTAGCAAGGCTAT	ACTCCTRCGGGAGGCAGCAG	Chicago.G.12
Chicago.G.2	GTAGAGAGTAAGTTCC	ACTCCTRCGGGAGGCAGCAG	Chicago.G.2
Chicago.G.3	GTAGAGAGCAGGACGT	ACTCCTRCGGGAGGCAGCAG	Chicago.G.3
Chicago.G.4	GTAGAGAGAAGGCTAT	ACTCCTRCGGGAGGCAGCAG	Chicago.G.4
Chicago.G.5	CCTCTCTGAAGGAGTA	ACTCCTRCGGGAGGCAGCAG	Chicago.G.5
Chicago.G.6	CCTCTCTGTAAGTTCC	ACTCCTRCGGGAGGCAGCAG	Chicago.G.6
Chicago.G.7	CCTCTCTGCAGGACGT	ACTCCTRCGGGAGGCAGCAG	Chicago.G.7
Chicago.G.8	CCTCTCTGAAGGCTAT	ACTCCTRCGGGAGGCAGCAG	Chicago.G.8
Chicago.G.9	AGCGTAGCAAGGAGTA	ACTCCTRCGGGAGGCAGCAG	Chicago.G.9
Chicago.H.1	GTAGAGAGCTAAGCCT	ACTCCTRCGGGAGGCAGCAG	Chicago.H.1
Chicago.H.10	AGCGTAGCTAGACCTA	ACTCCTRCGGGAGGCAGCAG	Chicago.H.10
Chicago.H.11	AGCGTAGCGTACTGAC	ACTCCTRCGGGAGGCAGCAG	Chicago.H.11
Chicago.H.12	AGCGTAGCGAGCCTTA	ACTCCTRCGGGAGGCAGCAG	Chicago.H.12
Chicago.H.2	GTAGAGAGTAGACCTA	ACTCCTRCGGGAGGCAGCAG	Chicago.H.2
Chicago.H.3	GTAGAGAGGTACTGAC	ACTCCTRCGGGAGGCAGCAG	Chicago.H.3
Chicago.H.4	GTAGAGAGGAGCCTTA	ACTCCTRCGGGAGGCAGCAG	Chicago.H.4
Chicago.H.5	CCTCTCTGCTAAGCCT	ACTCCTRCGGGAGGCAGCAG	Chicago.H.5
Chicago.H.6	CCTCTCTGTAGACCTA	ACTCCTRCGGGAGGCAGCAG	Chicago.H.6
Chicago.H.7	CCTCTCTGGTACTGAC	ACTCCTRCGGGAGGCAGCAG	Chicago.H.7
Chicago.H.8	CCTCTCTGGAGCCTTA	ACTCCTRCGGGAGGCAGCAG	Chicago.H.8
Chicago.H.9	AGCGTAGCCTAAGCCT	ACTCCTRCGGGAGGCAGCAG	Chicago.H.9
Denver.A.1	CAGCCTCGTAGATCGC	ACTCCTRCGGGAGGCAGCAG	Denver.A.1
Denver.A.10	TCCTCTACTGAACCTT	ACTCCTRCGGGAGGCAGCAG	Denver.A.10
Denver.A.11	TCCTCTACTATAGCCT	ACTCCTRCGGGAGGCAGCAG	Denver.A.11
Denver.A.12	TCCTCTACCGTCTAAT	ACTCCTRCGGGAGGCAGCAG	Denver.A.12
Denver.A.2	CAGCCTCGTGAACCTT	ACTCCTRCGGGAGGCAGCAG	Denver.A.2
Denver.A.3	CAGCCTCGTATAGCCT	ACTCCTRCGGGAGGCAGCAG	Denver.A.3
Denver.A.4	CAGCCTCGCGTCTAAT	ACTCCTRCGGGAGGCAGCAG	Denver.A.4
Denver.A.5	TGCCTCTTTAGATCGC	ACTCCTRCGGGAGGCAGCAG	Denver.A.5
Denver.A.6	TGCCTCTTTGAACCTT	ACTCCTRCGGGAGGCAGCAG	Denver.A.6
Denver.A.7	TGCCTCTTTATAGCCT	ACTCCTRCGGGAGGCAGCAG	Denver.A.7
Denver.A.8	TGCCTCTTCGTCTAAT	ACTCCTRCGGGAGGCAGCAG	Denver.A.8
Denver.A.9	TCCTCTACTAGATCGC	ACTCCTRCGGGAGGCAGCAG	Denver.A.9
Denver.B.1	CAGCCTCGCTCTCTAT	ACTCCTRCGGGAGGCAGCAG	Denver.B.1
Denver.B.10	TCCTCTACTGCTAAGT	ACTCCTRCGGGAGGCAGCAG	Denver.B.10
Denver.B.11	TCCTCTACATAGAGGC	ACTCCTRCGGGAGGCAGCAG	Denver.B.11
Denver.B.12	TCCTCTACTCTCTCCG	ACTCCTRCGGGAGGCAGCAG	Denver.B.12
Denver.B.2	CAGCCTCGTGCTAAGT	ACTCCTRCGGGAGGCAGCAG	Denver.B.2
Denver.B.3	CAGCCTCGATAGAGGC	ACTCCTRCGGGAGGCAGCAG	Denver.B.3
Denver.B.4	CAGCCTCGTCTCTCCG	ACTCCTRCGGGAGGCAGCAG	Denver.B.4
Denver.B.5	TGCCTCTTCTCTCTAT	ACTCCTRCGGGAGGCAGCAG	Denver.B.5
Denver.B.6	TGCCTCTTTGCTAAGT	ACTCCTRCGGGAGGCAGCAG	Denver.B.6
Denver.B.7	TGCCTCTTATAGAGGC	ACTCCTRCGGGAGGCAGCAG	Denver.B.7
Denver.B.8	TGCCTCTTTCTCTCCG	ACTCCTRCGGGAGGCAGCAG	Denver.B.8
Denver.B.9	TCCTCTACCTCTCTAT	ACTCCTRCGGGAGGCAGCAG	Denver.B.9
Denver.C.1	CAGCCTCGTATCCTCT	ACTCCTRCGGGAGGCAGCAG	Denver.C.1
Denver.C.10	TCCTCTACTGTTCTCT	ACTCCTRCGGGAGGCAGCAG	Denver.C.10
Denver.C.11	TCCTCTACCCTATCCT	ACTCCTRCGGGAGGCAGCAG	Denver.C.11
Denver.C.12	TCCTCTACTCGACTAG	ACTCCTRCGGGAGGCAGCAG	Denver.C.12
Denver.C.2	CAGCCTCGTGTTCTCT	ACTCCTRCGGGAGGCAGCAG	Denver.C.2
Denver.C.3	CAGCCTCGCCTATCCT	ACTCCTRCGGGAGGCAGCAG	Denver.C.3
Denver.C.4	CAGCCTCGTCGACTAG	ACTCCTRCGGGAGGCAGCAG	Denver.C.4
Denver.C.5	TGCCTCTTTATCCTCT	ACTCCTRCGGGAGGCAGCAG	Denver.C.5
Denver.C.6	TGCCTCTTTGTTCTCT	ACTCCTRCGGGAGGCAGCAG	Denver.C.6
Denver.C.7	TGCCTCTTCCTATCCT	ACTCCTRCGGGAGGCAGCAG	Denver.C.7
Denver.C.8	TGCCTCTTTCGACTAG	ACTCCTRCGGGAGGCAGCAG	Denver.C.8
Denver.C.9	TCCTCTACTATCCTCT	ACTCCTRCGGGAGGCAGCAG	Denver.C.9
Denver.D.1	CAGCCTCGAGAGTAGA	ACTCCTRCGGGAGGCAGCAG	Denver.D.1
Denver.D.10	TCCTCTACTAAGACAC	ACTCCTRCGGGAGGCAGCAG	Denver.D.10
Denver.D.11	TCCTCTACGGCTCTGA	ACTCCTRCGGGAGGCAGCAG	Denver.D.11
Denver.D.12	TCCTCTACTTCTAGCT	ACTCCTRCGGGAGGCAGCAG	Denver.D.12
Denver.D.2	CAGCCTCGTAAGACAC	ACTCCTRCGGGAGGCAGCAG	Denver.D.2
Denver.D.3	CAGCCTCGGGCTCTGA	ACTCCTRCGGGAGGCAGCAG	Denver.D.3
Denver.D.4	CAGCCTCGTTCTAGCT	ACTCCTRCGGGAGGCAGCAG	Denver.D.4
Denver.D.5	TGCCTCTTAGAGTAGA	ACTCCTRCGGGAGGCAGCAG	Denver.D.5
Denver.D.6	TGCCTCTTTAAGACAC	ACTCCTRCGGGAGGCAGCAG	Denver.D.6
Denver.D.7	TGCCTCTTGGCTCTGA	ACTCCTRCGGGAGGCAGCAG	Denver.D.7
Denver.D.8	TGCCTCTTTTCTAGCT	ACTCCTRCGGGAGGCAGCAG	Denver.D.8
Denver.D.9	TCCTCTACAGAGTAGA	ACTCCTRCGGGAGGCAGCAG	Denver.D.9
Denver.E.1	CAGCCTCGGTAAGGAG	ACTCCTRCGGGAGGCAGCAG	Denver.E.1
Denver.E.10	TCCTCTACCTAATCGA	ACTCCTRCGGGAGGCAGCAG	Denver.E.10
Denver.E.11	TCCTCTACAGGCGAAG	ACTCCTRCGGGAGGCAGCAG	Denver.E.11
Denver.E.12	TCCTCTACCCTAGAGT	ACTCCTRCGGGAGGCAGCAG	Denver.E.12
Denver.E.2	CAGCCTCGCTAATCGA	ACTCCTRCGGGAGGCAGCAG	Denver.E.2
Denver.E.3	CAGCCTCGAGGCGAAG	ACTCCTRCGGGAGGCAGCAG	Denver.E.3
Denver.E.4	CAGCCTCGCCTAGAGT	ACTCCTRCGGGAGGCAGCAG	Denver.E.4
Denver.E.5	TGCCTCTTGTAAGGAG	ACTCCTRCGGGAGGCAGCAG	Denver.E.5
Denver.E.6	TGCCTCTTCTAATCGA	ACTCCTRCGGGAGGCAGCAG	Denver.E.6
Denver.E.7	TGCCTCTTAGGCGAAG	ACTCCTRCGGGAGGCAGCAG	Denver.E.7
Denver.E.8	TGCCTCTTCCTAGAGT	ACTCCTRCGGGAGGCAGCAG	Denver.E.8
Denver.E.9	TCCTCTACGTAAGGAG	ACTCCTRCGGGAGGCAGCAG	Denver.E.9
Denver.F.1	CAGCCTCGACTGCATA	ACTCCTRCGGGAGGCAGCAG	Denver.F.1
Denver.F.10	TCCTCTACCTAGAACA	ACTCCTRCGGGAGGCAGCAG	Denver.F.10
Denver.F.11	TCCTCTACTAATCTTA	ACTCCTRCGGGAGGCAGCAG	Denver.F.11
Denver.F.12	TCCTCTACCTATTAAG	ACTCCTRCGGGAGGCAGCAG	Denver.F.12
Denver.F.2	CAGCCTCGCTAGAACA	ACTCCTRCGGGAGGCAGCAG	Denver.F.2
Denver.F.3	CAGCCTCGTAATCTTA	ACTCCTRCGGGAGGCAGCAG	Denver.F.3
Denver.F.4	CAGCCTCGCTATTAAG	ACTCCTRCGGGAGGCAGCAG	Denver.F.4
Denver.F.5	TGCCTCTTACTGCATA	ACTCCTRCGGGAGGCAGCAG	Denver.F.5
Denver.F.6	TGCCTCTTCTAGAACA	ACTCCTRCGGGAGGCAGCAG	Denver.F.6
Denver.F.7	TGCCTCTTTAATCTTA	ACTCCTRCGGGAGGCAGCAG	Denver.F.7
Denver.F.8	TGCCTCTTCTATTAAG	ACTCCTRCGGGAGGCAGCAG	Denver.F.8
Denver.F.9	TCCTCTACACTGCATA	ACTCCTRCGGGAGGCAGCAG	Denver.F.9
Denver.G.1	CAGCCTCGAAGGAGTA	ACTCCTRCGGGAGGCAGCAG	Denver.G.1
Denver.G.10	TCCTCTACTAAGTTCC	ACTCCTRCGGGAGGCAGCAG	Denver.G.10
Denver.G.11	TCCTCTACCAGGACGT	ACTCCTRCGGGAGGCAGCAG	Denver.G.11
Denver.G.12	TCCTCTACAAGGCTAT	ACTCCTRCGGGAGGCAGCAG	Denver.G.12
Denver.G.2	CAGCCTCGTAAGTTCC	ACTCCTRCGGGAGGCAGCAG	Denver.G.2
Denver.G.3	CAGCCTCGCAGGACGT	ACTCCTRCGGGAGGCAGCAG	Denver.G.3
Denver.G.4	CAGCCTCGAAGGCTAT	ACTCCTRCGGGAGGCAGCAG	Denver.G.4
Denver.G.5	TGCCTCTTAAGGAGTA	ACTCCTRCGGGAGGCAGCAG	Denver.G.5
Denver.G.6	TGCCTCTTTAAGTTCC	ACTCCTRCGGGAGGCAGCAG	Denver.G.6
Denver.G.7	TGCCTCTTCAGGACGT	ACTCCTRCGGGAGGCAGCAG	Denver.G.7
Denver.G.8	TGCCTCTTAAGGCTAT	ACTCCTRCGGGAGGCAGCAG	Denver.G.8
Denver.G.9	TCCTCTACAAGGAGTA	ACTCCTRCGGGAGGCAGCAG	Denver.G.9
Denver.H.1	CAGCCTCGCTAAGCCT	ACTCCTRCGGGAGGCAGCAG	Denver.H.1
Denver.H.10	TCCTCTACTAGACCTA	ACTCCTRCGGGAGGCAGCAG	Denver.H.10
Denver.H.11	TCCTCTACGTACTGAC	ACTCCTRCGGGAGGCAGCAG	Denver.H.11
Denver.H.12	TCCTCTACGAGCCTTA	ACTCCTRCGGGAGGCAGCAG	Denver.H.12
Denver.H.2	CAGCCTCGTAGACCTA	ACTCCTRCGGGAGGCAGCAG	Denver.H.2
Denver.H.3	CAGCCTCGGTACTGAC	ACTCCTRCGGGAGGCAGCAG	Denver.H.3
Denver.H.4	CAGCCTCGGAGCCTTA	ACTCCTRCGGGAGGCAGCAG	Denver.H.4
Denver.H.5	TGCCTCTTCTAAGCCT	ACTCCTRCGGGAGGCAGCAG	Denver.H.5
Denver.H.6	TGCCTCTTTAGACCTA	ACTCCTRCGGGAGGCAGCAG	Denver.H.6
Denver.H.7	TGCCTCTTGTACTGAC	ACTCCTRCGGGAGGCAGCAG	Denver.H.7
Denver.H.8	TGCCTCTTGAGCCTTA	ACTCCTRCGGGAGGCAGCAG	Denver.H.8
Denver.H.9	TCCTCTACCTAAGCCT	ACTCCTRCGGGAGGCAGCAG	Denver.H.9
Edinburgh.A.1	GTCGTGATTAGATCGC	ACTCCTRCGGGAGGCAGCAG	Edinburgh.A.1
Edinburgh.A.10	TGGATCTGTGAACCTT	ACTCCTRCGGGAGGCAGCAG	Edinburgh.A.10
Edinburgh.A.11	TGGATCTGTATAGCCT	ACTCCTRCGGGAGGCAGCAG	Edinburgh.A.11
Edinburgh.A.12	TGGATCTGCGTCTAAT	ACTCCTRCGGGAGGCAGCAG	Edinburgh.A.12
Edinburgh.A.2	GTCGTGATTGAACCTT	ACTCCTRCGGGAGGCAGCAG	Edinburgh.A.2
Edinburgh.A.3	GTCGTGATTATAGCCT	ACTCCTRCGGGAGGCAGCAG	Edinburgh.A.3
Edinburgh.A.4	GTCGTGATCGTCTAAT	ACTCCTRCGGGAGGCAGCAG	Edinburgh.A.4
Edinburgh.A.5	ACCACTGTTAGATCGC	ACTCCTRCGGGAGGCAGCAG	Edinburgh.A.5
Edinburgh.A.6	ACCACTGTTGAACCTT	ACTCCTRCGGGAGGCAGCAG	Edinburgh.A.6
Edinburgh.A.7	ACCACTGTTATAGCCT	ACTCCTRCGGGAGGCAGCAG	Edinburgh.A.7
Edinburgh.A.8	ACCACTGTCGTCTAAT	ACTCCTRCGGGAGGCAGCAG	Edinburgh.A.8
Edinburgh.A.9	TGGATCTGTAGATCGC	ACTCCTRCGGGAGGCAGCAG	Edinburgh.A.9
Edinburgh.B.1	GTCGTGATCTCTCTAT	ACTCCTRCGGGAGGCAGCAG	Edinburgh.B.1
Edinburgh.B.10	TGGATCTGTGCTAAGT	ACTCCTRCGGGAGGCAGCAG	Edinburgh.B.10
Edinburgh.B.11	TGGATCTGATAGAGGC	ACTCCTRCGGGAGGCAGCAG	Edinburgh.B.11
Edinburgh.B.12	TGGATCTGTCTCTCCG	ACTCCTRCGGGAGGCAGCAG	Edinburgh.B.12
Edinburgh.B.2	GTCGTGATTGCTAAGT	ACTCCTRCGGGAGGCAGCAG	Edinburgh.B.2
Edinburgh.B.3	GTCGTGATATAGAGGC	ACTCCTRCGGGAGGCAGCAG	Edinburgh.B.3
Edinburgh.B.4	GTCGTGATTCTCTCCG	ACTCCTRCGGGAGGCAGCAG	Edinburgh.B.4
Edinburgh.B.5	ACCACTGTCTCTCTAT	ACTCCTRCGGGAGGCAGCAG	Edinburgh.B.5
Edinburgh.B.6	ACCACTGTTGCTAAGT	ACTCCTRCGGGAGGCAGCAG	Edinburgh.B.6
Edinburgh.B.7	ACCACTGTATAGAGGC	ACTCCTRCGGGAGGCAGCAG	Edinburgh.B.7
Edinburgh.B.8	ACCACTGTTCTCTCCG	ACTCCTRCGGGAGGCAGCAG	Edinburgh.B.8
Edinburgh.B.9	TGGATCTGCTCTCTAT	ACTCCTRCGGGAGGCAGCAG	Edinburgh.B.9
Edinburgh.C.1	GTCGTGATTATCCTCT	ACTCCTRCGGGAGGCAGCAG	Edinburgh.C.1
Edinburgh.C.10	TGGATCTGTGTTCTCT	ACTCCTRCGGGAGGCAGCAG	Edinburgh.C.10
Edinburgh.C.11	TGGATCTGCCTATCCT	ACTCCTRCGGGAGGCAGCAG	Edinburgh.C.11
Edinburgh.C.12	TGGATCTGTCGACTAG	ACTCCTRCGGGAGGCAGCAG	Edinburgh.C.12
Edinburgh.C.2	GTCGTGATTGTTCTCT	ACTCCTRCGGGAGGCAGCAG	Edinburgh.C.2
Edinburgh.C.3	GTCGTGATCCTATCCT	ACTCCTRCGGGAGGCAGCAG	Edinburgh.C.3
Edinburgh.C.4	GTCGTGATTCGACTAG	ACTCCTRCGGGAGGCAGCAG	Edinburgh.C.4
Edinburgh.C.5	ACCACTGTTATCCTCT	ACTCCTRCGGGAGGCAGCAG	Edinburgh.C.5
Edinburgh.C.6	ACCACTGTTGTTCTCT	ACTCCTRCGGGAGGCAGCAG	Edinburgh.C.6
Edinburgh.C.7	ACCACTGTCCTATCCT	ACTCCTRCGGGAGGCAGCAG	Edinburgh.C.7
Edinburgh.C.8	ACCACTGTTCGACTAG	ACTCCTRCGGGAGGCAGCAG	Edinburgh.C.8
Edinburgh.C.9	TGGATCTGTATCCTCT	ACTCCTRCGGGAGGCAGCAG	Edinburgh.C.9
Edinburgh.D.1	GTCGTGATAGAGTAGA	ACTCCTRCGGGAGGCAGCAG	Edinburgh.D.1
Edinburgh.D.10	TGGATCTGTAAGACAC	ACTCCTRCGGGAGGCAGCAG	Edinburgh.D.10
Edinburgh.D.11	TGGATCTGGGCTCTGA	ACTCCTRCGGGAGGCAGCAG	Edinburgh.D.11
Edinburgh.D.12	TGGATCTGTTCTAGCT	ACTCCTRCGGGAGGCAGCAG	Edinburgh.D.12
Edinburgh.D.2	GTCGTGATTAAGACAC	ACTCCTRCGGGAGGCAGCAG	Edinburgh.D.2
Edinburgh.D.3	GTCGTGATGGCTCTGA	ACTCCTRCGGGAGGCAGCAG	Edinburgh.D.3
Edinburgh.D.4	GTCGTGATTTCTAGCT	ACTCCTRCGGGAGGCAGCAG	Edinburgh.D.4
Edinburgh.D.5	ACCACTGTAGAGTAGA	ACTCCTRCGGGAGGCAGCAG	Edinburgh.D.5
Edinburgh.D.6	ACCACTGTTAAGACAC	ACTCCTRCGGGAGGCAGCAG	Edinburgh.D.6
Edinburgh.D.7	ACCACTGTGGCTCTGA	ACTCCTRCGGGAGGCAGCAG	Edinburgh.D.7
Edinburgh.D.8	ACCACTGTTTCTAGCT	ACTCCTRCGGGAGGCAGCAG	Edinburgh.D.8
Edinburgh.D.9	TGGATCTGAGAGTAGA	ACTCCTRCGGGAGGCAGCAG	Edinburgh.D.9
Edinburgh.E.1	GTCGTGATGTAAGGAG	ACTCCTRCGGGAGGCAGCAG	Edinburgh.E.1
Edinburgh.E.10	TGGATCTGCTAATCGA	ACTCCTRCGGGAGGCAGCAG	Edinburgh.E.10
Edinburgh.E.11	TGGATCTGAGGCGAAG	ACTCCTRCGGGAGGCAGCAG	Edinburgh.E.11
Edinburgh.E.12	TGGATCTGCCTAGAGT	ACTCCTRCGGGAGGCAGCAG	Edinburgh.E.12
Edinburgh.E.2	GTCGTGATCTAATCGA	ACTCCTRCGGGAGGCAGCAG	Edinburgh.E.2
Edinburgh.E.3	GTCGTGATAGGCGAAG	ACTCCTRCGGGAGGCAGCAG	Edinburgh.E.3
Edinburgh.E.4	GTCGTGATCCTAGAGT	ACTCCTRCGGGAGGCAGCAG	Edinburgh.E.4
Edinburgh.E.5	ACCACTGTGTAAGGAG	ACTCCTRCGGGAGGCAGCAG	Edinburgh.E.5
Edinburgh.E.6	ACCACTGTCTAATCGA	ACTCCTRCGGGAGGCAGCAG	Edinburgh.E.6
Edinburgh.E.7	ACCACTGTAGGCGAAG	ACTCCTRCGGGAGGCAGCAG	Edinburgh.E.7
Edinburgh.E.8	ACCACTGTCCTAGAGT	ACTCCTRCGGGAGGCAGCAG	Edinburgh.E.8
Edinburgh.E.9	TGGATCTGGTAAGGAG	ACTCCTRCGGGAGGCAGCAG	Edinburgh.E.9
Edinburgh.F.1	GTCGTGATACTGCATA	ACTCCTRCGGGAGGCAGCAG	Edinburgh.F.1
Edinburgh.F.10	TGGATCTGCTAGAACA	ACTCCTRCGGGAGGCAGCAG	Edinburgh.F.10
Edinburgh.F.11	TGGATCTGTAATCTTA	ACTCCTRCGGGAGGCAGCAG	Edinburgh.F.11
Edinburgh.F.12	TGGATCTGCTATTAAG	ACTCCTRCGGGAGGCAGCAG	Edinburgh.F.12
Edinburgh.F.2	GTCGTGATCTAGAACA	ACTCCTRCGGGAGGCAGCAG	Edinburgh.F.2
Edinburgh.F.3	GTCGTGATTAATCTTA	ACTCCTRCGGGAGGCAGCAG	Edinburgh.F.3
Edinburgh.F.4	GTCGTGATCTATTAAG	ACTCCTRCGGGAGGCAGCAG	Edinburgh.F.4
Edinburgh.F.5	ACCACTGTACTGCATA	ACTCCTRCGGGAGGCAGCAG	Edinburgh.F.5
Edinburgh.F.6	ACCACTGTCTAGAACA	ACTCCTRCGGGAGGCAGCAG	Edinburgh.F.6
Edinburgh.F.7	ACCACTGTTAATCTTA	ACTCCTRCGGGAGGCAGCAG	Edinburgh.F.7
Edinburgh.F.8	ACCACTGTCTATTAAG	ACTCCTRCGGGAGGCAGCAG	Edinburgh.F.8
Edinburgh.F.9	TGGATCTGACTGCATA	ACTCCTRCGGGAGGCAGCAG	Edinburgh.F.9
Edinburgh.G.1	GTCGTGATAAGGAGTA	ACTCCTRCGGGAGGCAGCAG	Edinburgh.G.1
Edinburgh.G.10	TGGATCTGTAAGTTCC	ACTCCTRCGGGAGGCAGCAG	Edinburgh.G.10
Edinburgh.G.11	TGGATCTGCAGGACGT	ACTCCTRCGGGAGGCAGCAG	Edinburgh.G.11
Edinburgh.G.12	TGGATCTGAAGGCTAT	ACTCCTRCGGGAGGCAGCAG	Edinburgh.G.12
Edinburgh.G.2	GTCGTGATTAAGTTCC	ACTCCTRCGGGAGGCAGCAG	Edinburgh.G.2
Edinburgh.G.3	GTCGTGATCAGGACGT	ACTCCTRCGGGAGGCAGCAG	Edinburgh.G.3
Edinburgh.G.4	GTCGTGATAAGGCTAT	ACTCCTRCGGGAGGCAGCAG	Edinburgh.G.4
Edinburgh.G.5	ACCACTGTAAGGAGTA	ACTCCTRCGGGAGGCAGCAG	Edinburgh.G.5
Edinburgh.G.6	ACCACTGTTAAGTTCC	ACTCCTRCGGGAGGCAGCAG	Edinburgh.G.6
Edinburgh.G.7	ACCACTGTCAGGACGT	ACTCCTRCGGGAGGCAGCAG	Edinburgh.G.7
Edinburgh.G.8	ACCACTGTAAGGCTAT	ACTCCTRCGGGAGGCAGCAG	Edinburgh.G.8
Edinburgh.G.9	TGGATCTGAAGGAGTA	ACTCCTRCGGGAGGCAGCAG	Edinburgh.G.9
Edinburgh.H.1	GTCGTGATCTAAGCCT	ACTCCTRCGGGAGGCAGCAG	Edinburgh.H.1
Edinburgh.H.10	TGGATCTGTAGACCTA	ACTCCTRCGGGAGGCAGCAG	Edinburgh.H.10
Edinburgh.H.11	TGGATCTGGTACTGAC	ACTCCTRCGGGAGGCAGCAG	Edinburgh.H.11
Edinburgh.H.12	TGGATCTGGAGCCTTA	ACTCCTRCGGGAGGCAGCAG	Edinburgh.H.12
Edinburgh.H.2	GTCGTGATTAGACCTA	ACTCCTRCGGGAGGCAGCAG	Edinburgh.H.2
Edinburgh.H.3	GTCGTGATGTACTGAC	ACTCCTRCGGGAGGCAGCAG	Edinburgh.H.3
Edinburgh.H.4	GTCGTGATGAGCCTTA	ACTCCTRCGGGAGGCAGCAG	Edinburgh.H.4
Edinburgh.H.5	ACCACTGTCTAAGCCT	ACTCCTRCGGGAGGCAGCAG	Edinburgh.H.5
Edinburgh.H.6	ACCACTGTTAGACCTA	ACTCCTRCGGGAGGCAGCAG	Edinburgh.H.6
Edinburgh.H.7	ACCACTGTGTACTGAC	ACTCCTRCGGGAGGCAGCAG	Edinburgh.H.7
Edinburgh.H.8	ACCACTGTGAGCCTTA	ACTCCTRCGGGAGGCAGCAG	Edinburgh.H.8
Edinburgh.H.9	TGGATCTGCTAAGCCT	ACTCCTRCGGGAGGCAGCAG	Edinburgh.H.9
Florence.A.1	CCGTTTGTTAGATCGC	ACTCCTRCGGGAGGCAGCAG	Florence.A.1
Florence.A.10	GAGGGGTTTGAACCTT	ACTCCTRCGGGAGGCAGCAG	Florence.A.10
Florence.A.11	GAGGGGTTTATAGCCT	ACTCCTRCGGGAGGCAGCAG	Florence.A.11
Florence.A.12	GAGGGGTTCGTCTAAT	ACTCCTRCGGGAGGCAGCAG	Florence.A.12
Florence.A.2	CCGTTTGTTGAACCTT	ACTCCTRCGGGAGGCAGCAG	Florence.A.2
Florence.A.3	CCGTTTGTTATAGCCT	ACTCCTRCGGGAGGCAGCAG	Florence.A.3
Florence.A.4	CCGTTTGTCGTCTAAT	ACTCCTRCGGGAGGCAGCAG	Florence.A.4
Florence.A.5	TGCTGGGTTAGATCGC	ACTCCTRCGGGAGGCAGCAG	Florence.A.5
Florence.A.6	TGCTGGGTTGAACCTT	ACTCCTRCGGGAGGCAGCAG	Florence.A.6
Florence.A.7	TGCTGGGTTATAGCCT	ACTCCTRCGGGAGGCAGCAG	Florence.A.7
Florence.A.8	TGCTGGGTCGTCTAAT	ACTCCTRCGGGAGGCAGCAG	Florence.A.8
Florence.A.9	GAGGGGTTTAGATCGC	ACTCCTRCGGGAGGCAGCAG	Florence.A.9
Florence.B.1	CCGTTTGTCTCTCTAT	ACTCCTRCGGGAGGCAGCAG	Florence.B.1
Florence.B.10	GAGGGGTTTGCTAAGT	ACTCCTRCGGGAGGCAGCAG	Florence.B.10
Florence.B.11	GAGGGGTTATAGAGGC	ACTCCTRCGGGAGGCAGCAG	Florence.B.11
Florence.B.12	GAGGGGTTTCTCTCCG	ACTCCTRCGGGAGGCAGCAG	Florence.B.12
Florence.B.2	CCGTTTGTTGCTAAGT	ACTCCTRCGGGAGGCAGCAG	Florence.B.2
Florence.B.3	CCGTTTGTATAGAGGC	ACTCCTRCGGGAGGCAGCAG	Florence.B.3
Florence.B.4	CCGTTTGTTCTCTCCG	ACTCCTRCGGGAGGCAGCAG	Florence.B.4
Florence.B.5	TGCTGGGTCTCTCTAT	ACTCCTRCGGGAGGCAGCAG	Florence.B.5
Florence.B.6	TGCTGGGTTGCTAAGT	ACTCCTRCGGGAGGCAGCAG	Florence.B.6
Florence.B.7	TGCTGGGTATAGAGGC	ACTCCTRCGGGAGGCAGCAG	Florence.B.7
Florence.B.8	TGCTGGGTTCTCTCCG	ACTCCTRCGGGAGGCAGCAG	Florence.B.8
Florence.B.9	GAGGGGTTCTCTCTAT	ACTCCTRCGGGAGGCAGCAG	Florence.B.9
Florence.C.1	CCGTTTGTTATCCTCT	ACTCCTRCGGGAGGCAGCAG	Florence.C.1
Florence.C.10	GAGGGGTTTGTTCTCT	ACTCCTRCGGGAGGCAGCAG	Florence.C.10
Florence.C.11	GAGGGGTTCCTATCCT	ACTCCTRCGGGAGGCAGCAG	Florence.C.11
Florence.C.12	GAGGGGTTTCGACTAG	ACTCCTRCGGGAGGCAGCAG	Florence.C.12
Florence.C.2	CCGTTTGTTGTTCTCT	ACTCCTRCGGGAGGCAGCAG	Florence.C.2
Florence.C.3	CCGTTTGTCCTATCCT	ACTCCTRCGGGAGGCAGCAG	Florence.C.3
Florence.C.4	CCGTTTGTTCGACTAG	ACTCCTRCGGGAGGCAGCAG	Florence.C.4
Florence.C.5	TGCTGGGTTATCCTCT	ACTCCTRCGGGAGGCAGCAG	Florence.C.5
Florence.C.6	TGCTGGGTTGTTCTCT	ACTCCTRCGGGAGGCAGCAG	Florence.C.6
Florence.C.7	TGCTGGGTCCTATCCT	ACTCCTRCGGGAGGCAGCAG	Florence.C.7
Florence.C.8	TGCTGGGTTCGACTAG	ACTCCTRCGGGAGGCAGCAG	Florence.C.8
Florence.C.9	GAGGGGTTTATCCTCT	ACTCCTRCGGGAGGCAGCAG	Florence.C.9
Florence.D.1	CCGTTTGTAGAGTAGA	ACTCCTRCGGGAGGCAGCAG	Florence.D.1
Florence.D.10	GAGGGGTTTAAGACAC	ACTCCTRCGGGAGGCAGCAG	Florence.D.10
Florence.D.11	GAGGGGTTGGCTCTGA	ACTCCTRCGGGAGGCAGCAG	Florence.D.11
Florence.D.12	GAGGGGTTTTCTAGCT	ACTCCTRCGGGAGGCAGCAG	Florence.D.12
Florence.D.2	CCGTTTGTTAAGACAC	ACTCCTRCGGGAGGCAGCAG	Florence.D.2
Florence.D.3	CCGTTTGTGGCTCTGA	ACTCCTRCGGGAGGCAGCAG	Florence.D.3
Florence.D.4	CCGTTTGTTTCTAGCT	ACTCCTRCGGGAGGCAGCAG	Florence.D.4
Florence.D.5	TGCTGGGTAGAGTAGA	ACTCCTRCGGGAGGCAGCAG	Florence.D.5
Florence.D.6	TGCTGGGTTAAGACAC	ACTCCTRCGGGAGGCAGCAG	Florence.D.6
Florence.D.7	TGCTGGGTGGCTCTGA	ACTCCTRCGGGAGGCAGCAG	Florence.D.7
Florence.D.8	TGCTGGGTTTCTAGCT	ACTCCTRCGGGAGGCAGCAG	Florence.D.8
Florence.D.9	GAGGGGTTAGAGTAGA	ACTCCTRCGGGAGGCAGCAG	Florence.D.9
Florence.E.1	CCGTTTGTGTAAGGAG	ACTCCTRCGGGAGGCAGCAG	Florence.E.1
Florence.E.10	GAGGGGTTCTAATCGA	ACTCCTRCGGGAGGCAGCAG	Florence.E.10
Florence.E.11	GAGGGGTTAGGCGAAG	ACTCCTRCGGGAGGCAGCAG	Florence.E.11
Florence.E.12	GAGGGGTTCCTAGAGT	ACTCCTRCGGGAGGCAGCAG	Florence.E.12
Florence.E.2	CCGTTTGTCTAATCGA	ACTCCTRCGGGAGGCAGCAG	Florence.E.2
Florence.E.3	CCGTTTGTAGGCGAAG	ACTCCTRCGGGAGGCAGCAG	Florence.E.3
Florence.E.4	CCGTTTGTCCTAGAGT	ACTCCTRCGGGAGGCAGCAG	Florence.E.4
Florence.E.5	TGCTGGGTGTAAGGAG	ACTCCTRCGGGAGGCAGCAG	Florence.E.5
Florence.E.6	TGCTGGGTCTAATCGA	ACTCCTRCGGGAGGCAGCAG	Florence.E.6
Florence.E.7	TGCTGGGTAGGCGAAG	ACTCCTRCGGGAGGCAGCAG	Florence.E.7
Florence.E.8	TGCTGGGTCCTAGAGT	ACTCCTRCGGGAGGCAGCAG	Florence.E.8
Florence.E.9	GAGGGGTTGTAAGGAG	ACTCCTRCGGGAGGCAGCAG	Florence.E.9
Florence.F.1	CCGTTTGTACTGCATA	ACTCCTRCGGGAGGCAGCAG	Florence.F.1
Florence.F.10	GAGGGGTTCTAGAACA	ACTCCTRCGGGAGGCAGCAG	Florence.F.10
Florence.F.11	GAGGGGTTTAATCTTA	ACTCCTRCGGGAGGCAGCAG	Florence.F.11
Florence.F.12	GAGGGGTTCTATTAAG	ACTCCTRCGGGAGGCAGCAG	Florence.F.12
Florence.F.2	CCGTTTGTCTAGAACA	ACTCCTRCGGGAGGCAGCAG	Florence.F.2
Florence.F.3	CCGTTTGTTAATCTTA	ACTCCTRCGGGAGGCAGCAG	Florence.F.3
Florence.F.4	CCGTTTGTCTATTAAG	ACTCCTRCGGGAGGCAGCAG	Florence.F.4
Florence.F.5	TGCTGGGTACTGCATA	ACTCCTRCGGGAGGCAGCAG	Florence.F.5
Florence.F.6	TGCTGGGTCTAGAACA	ACTCCTRCGGGAGGCAGCAG	Florence.F.6
Florence.F.7	TGCTGGGTTAATCTTA	ACTCCTRCGGGAGGCAGCAG	Florence.F.7
Florence.F.8	TGCTGGGTCTATTAAG	ACTCCTRCGGGAGGCAGCAG	Florence.F.8
Florence.F.9	GAGGGGTTACTGCATA	ACTCCTRCGGGAGGCAGCAG	Florence.F.9
Florence.G.1	CCGTTTGTAAGGAGTA	ACTCCTRCGGGAGGCAGCAG	Florence.G.1
Florence.G.10	GAGGGGTTTAAGTTCC	ACTCCTRCGGGAGGCAGCAG	Florence.G.10
Florence.G.11	GAGGGGTTCAGGACGT	ACTCCTRCGGGAGGCAGCAG	Florence.G.11
Florence.G.12	GAGGGGTTAAGGCTAT	ACTCCTRCGGGAGGCAGCAG	Florence.G.12
Florence.G.2	CCGTTTGTTAAGTTCC	ACTCCTRCGGGAGGCAGCAG	Florence.G.2
Florence.G.3	CCGTTTGTCAGGACGT	ACTCCTRCGGGAGGCAGCAG	Florence.G.3
Florence.G.4	CCGTTTGTAAGGCTAT	ACTCCTRCGGGAGGCAGCAG	Florence.G.4
Florence.G.5	TGCTGGGTAAGGAGTA	ACTCCTRCGGGAGGCAGCAG	Florence.G.5
Florence.G.6	TGCTGGGTTAAGTTCC	ACTCCTRCGGGAGGCAGCAG	Florence.G.6
Florence.G.7	TGCTGGGTCAGGACGT	ACTCCTRCGGGAGGCAGCAG	Florence.G.7
Florence.G.8	TGCTGGGTAAGGCTAT	ACTCCTRCGGGAGGCAGCAG	Florence.G.8
Florence.G.9	GAGGGGTTAAGGAGTA	ACTCCTRCGGGAGGCAGCAG	Florence.G.9
Florence.H.1	CCGTTTGTCTAAGCCT	ACTCCTRCGGGAGGCAGCAG	Florence.H.1
Florence.H.10	GAGGGGTTTAGACCTA	ACTCCTRCGGGAGGCAGCAG	Florence.H.10
Florence.H.11	GAGGGGTTGTACTGAC	ACTCCTRCGGGAGGCAGCAG	Florence.H.11
Florence.H.12	GAGGGGTTGAGCCTTA	ACTCCTRCGGGAGGCAGCAG	Florence.H.12
Florence.H.2	CCGTTTGTTAGACCTA	ACTCCTRCGGGAGGCAGCAG	Florence.H.2
Florence.H.3	CCGTTTGTGTACTGAC	ACTCCTRCGGGAGGCAGCAG	Florence.H.3
Florence.H.4	CCGTTTGTGAGCCTTA	ACTCCTRCGGGAGGCAGCAG	Florence.H.4
Florence.H.5	TGCTGGGTCTAAGCCT	ACTCCTRCGGGAGGCAGCAG	Florence.H.5
Florence.H.6	TGCTGGGTTAGACCTA	ACTCCTRCGGGAGGCAGCAG	Florence.H.6
Florence.H.7	TGCTGGGTGTACTGAC	ACTCCTRCGGGAGGCAGCAG	Florence.H.7
Florence.H.8	TGCTGGGTGAGCCTTA	ACTCCTRCGGGAGGCAGCAG	Florence.H.8
Florence.H.9	GAGGGGTTCTAAGCCT	ACTCCTRCGGGAGGCAGCAG	Florence.H.9
Ganzhou.A.1	AGGTTGGGTAGATCGC	ACTCCTRCGGGAGGCAGCAG	Ganzhou.A.1
Ganzhou.A.10	TGGGTTTCTGAACCTT	ACTCCTRCGGGAGGCAGCAG	Ganzhou.A.10
Ganzhou.A.11	TGGGTTTCTATAGCCT	ACTCCTRCGGGAGGCAGCAG	Ganzhou.A.11
Ganzhou.A.12	TGGGTTTCCGTCTAAT	ACTCCTRCGGGAGGCAGCAG	Ganzhou.A.12
Ganzhou.A.2	AGGTTGGGTGAACCTT	ACTCCTRCGGGAGGCAGCAG	Ganzhou.A.2
Ganzhou.A.3	AGGTTGGGTATAGCCT	ACTCCTRCGGGAGGCAGCAG	Ganzhou.A.3
Ganzhou.A.4	AGGTTGGGCGTCTAAT	ACTCCTRCGGGAGGCAGCAG	Ganzhou.A.4
Ganzhou.A.5	GTGTGGTGTAGATCGC	ACTCCTRCGGGAGGCAGCAG	Ganzhou.A.5
Ganzhou.A.6	GTGTGGTGTGAACCTT	ACTCCTRCGGGAGGCAGCAG	Ganzhou.A.6
Ganzhou.A.7	GTGTGGTGTATAGCCT	ACTCCTRCGGGAGGCAGCAG	Ganzhou.A.7
Ganzhou.A.8	GTGTGGTGCGTCTAAT	ACTCCTRCGGGAGGCAGCAG	Ganzhou.A.8
Ganzhou.A.9	TGGGTTTCTAGATCGC	ACTCCTRCGGGAGGCAGCAG	Ganzhou.A.9
Ganzhou.B.1	AGGTTGGGCTCTCTAT	ACTCCTRCGGGAGGCAGCAG	Ganzhou.B.1
Ganzhou.B.10	TGGGTTTCTGCTAAGT	ACTCCTRCGGGAGGCAGCAG	Ganzhou.B.10
Ganzhou.B.11	TGGGTTTCATAGAGGC	ACTCCTRCGGGAGGCAGCAG	Ganzhou.B.11
Ganzhou.B.12	TGGGTTTCTCTCTCCG	ACTCCTRCGGGAGGCAGCAG	Ganzhou.B.12
Ganzhou.B.2	AGGTTGGGTGCTAAGT	ACTCCTRCGGGAGGCAGCAG	Ganzhou.B.2
Ganzhou.B.3	AGGTTGGGATAGAGGC	ACTCCTRCGGGAGGCAGCAG	Ganzhou.B.3
Ganzhou.B.4	AGGTTGGGTCTCTCCG	ACTCCTRCGGGAGGCAGCAG	Ganzhou.B.4
Ganzhou.B.5	GTGTGGTGCTCTCTAT	ACTCCTRCGGGAGGCAGCAG	Ganzhou.B.5
Ganzhou.B.6	GTGTGGTGTGCTAAGT	ACTCCTRCGGGAGGCAGCAG	Ganzhou.B.6
Ganzhou.B.7	GTGTGGTGATAGAGGC	ACTCCTRCGGGAGGCAGCAG	Ganzhou.B.7
Ganzhou.B.8	GTGTGGTGTCTCTCCG	ACTCCTRCGGGAGGCAGCAG	Ganzhou.B.8
Ganzhou.B.9	TGGGTTTCCTCTCTAT	ACTCCTRCGGGAGGCAGCAG	Ganzhou.B.9
Ganzhou.C.1	AGGTTGGGTATCCTCT	ACTCCTRCGGGAGGCAGCAG	Ganzhou.C.1
Ganzhou.C.10	TGGGTTTCTGTTCTCT	ACTCCTRCGGGAGGCAGCAG	Ganzhou.C.10
Ganzhou.C.11	TGGGTTTCCCTATCCT	ACTCCTRCGGGAGGCAGCAG	Ganzhou.C.11
Ganzhou.C.12	TGGGTTTCTCGACTAG	ACTCCTRCGGGAGGCAGCAG	Ganzhou.C.12
Ganzhou.C.2	AGGTTGGGTGTTCTCT	ACTCCTRCGGGAGGCAGCAG	Ganzhou.C.2
Ganzhou.C.3	AGGTTGGGCCTATCCT	ACTCCTRCGGGAGGCAGCAG	Ganzhou.C.3
Ganzhou.C.4	AGGTTGGGTCGACTAG	ACTCCTRCGGGAGGCAGCAG	Ganzhou.C.4
Ganzhou.C.5	GTGTGGTGTATCCTCT	ACTCCTRCGGGAGGCAGCAG	Ganzhou.C.5
Ganzhou.C.6	GTGTGGTGTGTTCTCT	ACTCCTRCGGGAGGCAGCAG	Ganzhou.C.6
Ganzhou.C.7	GTGTGGTGCCTATCCT	ACTCCTRCGGGAGGCAGCAG	Ganzhou.C.7
Ganzhou.C.8	GTGTGGTGTCGACTAG	ACTCCTRCGGGAGGCAGCAG	Ganzhou.C.8
Ganzhou.C.9	TGGGTTTCTATCCTCT	ACTCCTRCGGGAGGCAGCAG	Ganzhou.C.9
Ganzhou.D.1	AGGTTGGGAGAGTAGA	ACTCCTRCGGGAGGCAGCAG	Ganzhou.D.1
Ganzhou.D.10	TGGGTTTCTAAGACAC	ACTCCTRCGGGAGGCAGCAG	Ganzhou.D.10
Ganzhou.D.11	TGGGTTTCGGCTCTGA	ACTCCTRCGGGAGGCAGCAG	Ganzhou.D.11
Ganzhou.D.12	TGGGTTTCTTCTAGCT	ACTCCTRCGGGAGGCAGCAG	Ganzhou.D.12
Ganzhou.D.2	AGGTTGGGTAAGACAC	ACTCCTRCGGGAGGCAGCAG	Ganzhou.D.2
Ganzhou.D.3	AGGTTGGGGGCTCTGA	ACTCCTRCGGGAGGCAGCAG	Ganzhou.D.3
Ganzhou.D.4	AGGTTGGGTTCTAGCT	ACTCCTRCGGGAGGCAGCAG	Ganzhou.D.4
Ganzhou.D.5	GTGTGGTGAGAGTAGA	ACTCCTRCGGGAGGCAGCAG	Ganzhou.D.5
Ganzhou.D.6	GTGTGGTGTAAGACAC	ACTCCTRCGGGAGGCAGCAG	Ganzhou.D.6
Ganzhou.D.7	GTGTGGTGGGCTCTGA	ACTCCTRCGGGAGGCAGCAG	Ganzhou.D.7
Ganzhou.D.8	GTGTGGTGTTCTAGCT	ACTCCTRCGGGAGGCAGCAG	Ganzhou.D.8
Ganzhou.D.9	TGGGTTTCAGAGTAGA	ACTCCTRCGGGAGGCAGCAG	Ganzhou.D.9
Ganzhou.E.1	AGGTTGGGGTAAGGAG	ACTCCTRCGGGAGGCAGCAG	Ganzhou.E.1
Ganzhou.E.10	TGGGTTTCCTAATCGA	ACTCCTRCGGGAGGCAGCAG	Ganzhou.E.10
Ganzhou.E.11	TGGGTTTCAGGCGAAG	ACTCCTRCGGGAGGCAGCAG	Ganzhou.E.11
Ganzhou.E.12	TGGGTTTCCCTAGAGT	ACTCCTRCGGGAGGCAGCAG	Ganzhou.E.12
Ganzhou.E.2	AGGTTGGGCTAATCGA	ACTCCTRCGGGAGGCAGCAG	Ganzhou.E.2
Ganzhou.E.3	AGGTTGGGAGGCGAAG	ACTCCTRCGGGAGGCAGCAG	Ganzhou.E.3
Ganzhou.E.4	AGGTTGGGCCTAGAGT	ACTCCTRCGGGAGGCAGCAG	Ganzhou.E.4
Ganzhou.E.5	GTGTGGTGGTAAGGAG	ACTCCTRCGGGAGGCAGCAG	Ganzhou.E.5
Ganzhou.E.6	GTGTGGTGCTAATCGA	ACTCCTRCGGGAGGCAGCAG	Ganzhou.E.6
Ganzhou.E.7	GTGTGGTGAGGCGAAG	ACTCCTRCGGGAGGCAGCAG	Ganzhou.E.7
Ganzhou.E.8	GTGTGGTGCCTAGAGT	ACTCCTRCGGGAGGCAGCAG	Ganzhou.E.8
Ganzhou.E.9	TGGGTTTCGTAAGGAG	ACTCCTRCGGGAGGCAGCAG	Ganzhou.E.9
Ganzhou.F.1	AGGTTGGGACTGCATA	ACTCCTRCGGGAGGCAGCAG	Ganzhou.F.1
Ganzhou.F.10	TGGGTTTCCTAGAACA	ACTCCTRCGGGAGGCAGCAG	Ganzhou.F.10
Ganzhou.F.11	TGGGTTTCTAATCTTA	ACTCCTRCGGGAGGCAGCAG	Ganzhou.F.11
Ganzhou.F.12	TGGGTTTCCTATTAAG	ACTCCTRCGGGAGGCAGCAG	Ganzhou.F.12
Ganzhou.F.2	AGGTTGGGCTAGAACA	ACTCCTRCGGGAGGCAGCAG	Ganzhou.F.2
Ganzhou.F.3	AGGTTGGGTAATCTTA	ACTCCTRCGGGAGGCAGCAG	Ganzhou.F.3
Ganzhou.F.4	AGGTTGGGCTATTAAG	ACTCCTRCGGGAGGCAGCAG	Ganzhou.F.4
Ganzhou.F.5	GTGTGGTGACTGCATA	ACTCCTRCGGGAGGCAGCAG	Ganzhou.F.5
Ganzhou.F.6	GTGTGGTGCTAGAACA	ACTCCTRCGGGAGGCAGCAG	Ganzhou.F.6
Ganzhou.F.7	GTGTGGTGTAATCTTA	ACTCCTRCGGGAGGCAGCAG	Ganzhou.F.7
Ganzhou.F.8	GTGTGGTGCTATTAAG	ACTCCTRCGGGAGGCAGCAG	Ganzhou.F.8
Ganzhou.F.9	TGGGTTTCACTGCATA	ACTCCTRCGGGAGGCAGCAG	Ganzhou.F.9
Ganzhou.G.1	AGGTTGGGAAGGAGTA	ACTCCTRCGGGAGGCAGCAG	Ganzhou.G.1
Ganzhou.G.10	TGGGTTTCTAAGTTCC	ACTCCTRCGGGAGGCAGCAG	Ganzhou.G.10
Ganzhou.G.11	TGGGTTTCCAGGACGT	ACTCCTRCGGGAGGCAGCAG	Ganzhou.G.11
Ganzhou.G.12	TGGGTTTCAAGGCTAT	ACTCCTRCGGGAGGCAGCAG	Ganzhou.G.12
Ganzhou.G.2	AGGTTGGGTAAGTTCC	ACTCCTRCGGGAGGCAGCAG	Ganzhou.G.2
Ganzhou.G.3	AGGTTGGGCAGGACGT	ACTCCTRCGGGAGGCAGCAG	Ganzhou.G.3
Ganzhou.G.4	AGGTTGGGAAGGCTAT	ACTCCTRCGGGAGGCAGCAG	Ganzhou.G.4
Ganzhou.G.5	GTGTGGTGAAGGAGTA	ACTCCTRCGGGAGGCAGCAG	Ganzhou.G.5
Ganzhou.G.6	GTGTGGTGTAAGTTCC	ACTCCTRCGGGAGGCAGCAG	Ganzhou.G.6
Ganzhou.G.7	GTGTGGTGCAGGACGT	ACTCCTRCGGGAGGCAGCAG	Ganzhou.G.7
Ganzhou.G.8	GTGTGGTGAAGGCTAT	ACTCCTRCGGGAGGCAGCAG	Ganzhou.G.8
Ganzhou.G.9	TGGGTTTCAAGGAGTA	ACTCCTRCGGGAGGCAGCAG	Ganzhou.G.9
Ganzhou.H.1	AGGTTGGGCTAAGCCT	ACTCCTRCGGGAGGCAGCAG	Ganzhou.H.1
Ganzhou.H.10	TGGGTTTCTAGACCTA	ACTCCTRCGGGAGGCAGCAG	Ganzhou.H.10
Ganzhou.H.11	TGGGTTTCGTACTGAC	ACTCCTRCGGGAGGCAGCAG	Ganzhou.H.11
Ganzhou.H.12	TGGGTTTCGAGCCTTA	ACTCCTRCGGGAGGCAGCAG	Ganzhou.H.12
Ganzhou.H.2	AGGTTGGGTAGACCTA	ACTCCTRCGGGAGGCAGCAG	Ganzhou.H.2
Ganzhou.H.3	AGGTTGGGGTACTGAC	ACTCCTRCGGGAGGCAGCAG	Ganzhou.H.3
Ganzhou.H.4	AGGTTGGGGAGCCTTA	ACTCCTRCGGGAGGCAGCAG	Ganzhou.H.4
Ganzhou.H.5	GTGTGGTGCTAAGCCT	ACTCCTRCGGGAGGCAGCAG	Ganzhou.H.5
Ganzhou.H.6	GTGTGGTGTAGACCTA	ACTCCTRCGGGAGGCAGCAG	Ganzhou.H.6
Ganzhou.H.7	GTGTGGTGGTACTGAC	ACTCCTRCGGGAGGCAGCAG	Ganzhou.H.7
Ganzhou.H.8	GTGTGGTGGAGCCTTA	ACTCCTRCGGGAGGCAGCAG	Ganzhou.H.8
Ganzhou.H.9	TGGGTTTCCTAAGCCT	ACTCCTRCGGGAGGCAGCAG	Ganzhou.H.9
Honolulu.A.1	TGGTCACATAGATCGC	ACTCCTRCGGGAGGCAGCAG	Honolulu.A.1
Honolulu.A.10	CCACTCCTTGAACCTT	ACTCCTRCGGGAGGCAGCAG	Honolulu.A.10
Honolulu.A.11	CCACTCCTTATAGCCT	ACTCCTRCGGGAGGCAGCAG	Honolulu.A.11
Honolulu.A.12	CCACTCCTCGTCTAAT	ACTCCTRCGGGAGGCAGCAG	Honolulu.A.12
Honolulu.A.2	TGGTCACATGAACCTT	ACTCCTRCGGGAGGCAGCAG	Honolulu.A.2
Honolulu.A.3	TGGTCACATATAGCCT	ACTCCTRCGGGAGGCAGCAG	Honolulu.A.3
Honolulu.A.4	TGGTCACACGTCTAAT	ACTCCTRCGGGAGGCAGCAG	Honolulu.A.4
Honolulu.A.5	TTGACCCTTAGATCGC	ACTCCTRCGGGAGGCAGCAG	Honolulu.A.5
Honolulu.A.6	TTGACCCTTGAACCTT	ACTCCTRCGGGAGGCAGCAG	Honolulu.A.6
Honolulu.A.7	TTGACCCTTATAGCCT	ACTCCTRCGGGAGGCAGCAG	Honolulu.A.7
Honolulu.A.8	TTGACCCTCGTCTAAT	ACTCCTRCGGGAGGCAGCAG	Honolulu.A.8
Honolulu.A.9	CCACTCCTTAGATCGC	ACTCCTRCGGGAGGCAGCAG	Honolulu.A.9
Honolulu.B.1	TGGTCACACTCTCTAT	ACTCCTRCGGGAGGCAGCAG	Honolulu.B.1
Honolulu.B.10	CCACTCCTTGCTAAGT	ACTCCTRCGGGAGGCAGCAG	Honolulu.B.10
Honolulu.B.11	CCACTCCTATAGAGGC	ACTCCTRCGGGAGGCAGCAG	Honolulu.B.11
Honolulu.B.12	CCACTCCTTCTCTCCG	ACTCCTRCGGGAGGCAGCAG	Honolulu.B.12
Honolulu.B.2	TGGTCACATGCTAAGT	ACTCCTRCGGGAGGCAGCAG	Honolulu.B.2
Honolulu.B.3	TGGTCACAATAGAGGC	ACTCCTRCGGGAGGCAGCAG	Honolulu.B.3
Honolulu.B.4	TGGTCACATCTCTCCG	ACTCCTRCGGGAGGCAGCAG	Honolulu.B.4
Honolulu.B.5	TTGACCCTCTCTCTAT	ACTCCTRCGGGAGGCAGCAG	Honolulu.B.5
Honolulu.B.6	TTGACCCTTGCTAAGT	ACTCCTRCGGGAGGCAGCAG	Honolulu.B.6
Honolulu.B.7	TTGACCCTATAGAGGC	ACTCCTRCGGGAGGCAGCAG	Honolulu.B.7
Honolulu.B.8	TTGACCCTTCTCTCCG	ACTCCTRCGGGAGGCAGCAG	Honolulu.B.8
Honolulu.B.9	CCACTCCTCTCTCTAT	ACTCCTRCGGGAGGCAGCAG	Honolulu.B.9
Honolulu.C.1	TGGTCACATATCCTCT	ACTCCTRCGGGAGGCAGCAG	Honolulu.C.1
Honolulu.C.10	CCACTCCTTGTTCTCT	ACTCCTRCGGGAGGCAGCAG	Honolulu.C.10
Honolulu.C.11	CCACTCCTCCTATCCT	ACTCCTRCGGGAGGCAGCAG	Honolulu.C.11
Honolulu.C.12	CCACTCCTTCGACTAG	ACTCCTRCGGGAGGCAGCAG	Honolulu.C.12
Honolulu.C.2	TGGTCACATGTTCTCT	ACTCCTRCGGGAGGCAGCAG	Honolulu.C.2
Honolulu.C.3	TGGTCACACCTATCCT	ACTCCTRCGGGAGGCAGCAG	Honolulu.C.3
Honolulu.C.4	TGGTCACATCGACTAG	ACTCCTRCGGGAGGCAGCAG	Honolulu.C.4
Honolulu.C.5	TTGACCCTTATCCTCT	ACTCCTRCGGGAGGCAGCAG	Honolulu.C.5
Honolulu.C.6	TTGACCCTTGTTCTCT	ACTCCTRCGGGAGGCAGCAG	Honolulu.C.6
Honolulu.C.7	TTGACCCTCCTATCCT	ACTCCTRCGGGAGGCAGCAG	Honolulu.C.7
Honolulu.C.8	TTGACCCTTCGACTAG	ACTCCTRCGGGAGGCAGCAG	Honolulu.C.8
Honolulu.C.9	CCACTCCTTATCCTCT	ACTCCTRCGGGAGGCAGCAG	Honolulu.C.9
Honolulu.D.1	TGGTCACAAGAGTAGA	ACTCCTRCGGGAGGCAGCAG	Honolulu.D.1
Honolulu.D.10	CCACTCCTTAAGACAC	ACTCCTRCGGGAGGCAGCAG	Honolulu.D.10
Honolulu.D.11	CCACTCCTGGCTCTGA	ACTCCTRCGGGAGGCAGCAG	Honolulu.D.11
Honolulu.D.12	CCACTCCTTTCTAGCT	ACTCCTRCGGGAGGCAGCAG	Honolulu.D.12
Honolulu.D.2	TGGTCACATAAGACAC	ACTCCTRCGGGAGGCAGCAG	Honolulu.D.2
Honolulu.D.3	TGGTCACAGGCTCTGA	ACTCCTRCGGGAGGCAGCAG	Honolulu.D.3
Honolulu.D.4	TGGTCACATTCTAGCT	ACTCCTRCGGGAGGCAGCAG	Honolulu.D.4
Honolulu.D.5	TTGACCCTAGAGTAGA	ACTCCTRCGGGAGGCAGCAG	Honolulu.D.5
Honolulu.D.6	TTGACCCTTAAGACAC	ACTCCTRCGGGAGGCAGCAG	Honolulu.D.6
Honolulu.D.7	TTGACCCTGGCTCTGA	ACTCCTRCGGGAGGCAGCAG	Honolulu.D.7
Honolulu.D.8	TTGACCCTTTCTAGCT	ACTCCTRCGGGAGGCAGCAG	Honolulu.D.8
Honolulu.D.9	CCACTCCTAGAGTAGA	ACTCCTRCGGGAGGCAGCAG	Honolulu.D.9
Honolulu.E.1	TGGTCACAGTAAGGAG	ACTCCTRCGGGAGGCAGCAG	Honolulu.E.1
Honolulu.E.10	CCACTCCTCTAATCGA	ACTCCTRCGGGAGGCAGCAG	Honolulu.E.10
Honolulu.E.11	CCACTCCTAGGCGAAG	ACTCCTRCGGGAGGCAGCAG	Honolulu.E.11
Honolulu.E.12	CCACTCCTCCTAGAGT	ACTCCTRCGGGAGGCAGCAG	Honolulu.E.12
Honolulu.E.2	TGGTCACACTAATCGA	ACTCCTRCGGGAGGCAGCAG	Honolulu.E.2
Honolulu.E.3	TGGTCACAAGGCGAAG	ACTCCTRCGGGAGGCAGCAG	Honolulu.E.3
Honolulu.E.4	TGGTCACACCTAGAGT	ACTCCTRCGGGAGGCAGCAG	Honolulu.E.4
Honolulu.E.5	TTGACCCTGTAAGGAG	ACTCCTRCGGGAGGCAGCAG	Honolulu.E.5
Honolulu.E.6	TTGACCCTCTAATCGA	ACTCCTRCGGGAGGCAGCAG	Honolulu.E.6
Honolulu.E.7	TTGACCCTAGGCGAAG	ACTCCTRCGGGAGGCAGCAG	Honolulu.E.7
Honolulu.E.8	TTGACCCTCCTAGAGT	ACTCCTRCGGGAGGCAGCAG	Honolulu.E.8
Honolulu.E.9	CCACTCCTGTAAGGAG	ACTCCTRCGGGAGGCAGCAG	Honolulu.E.9
Honolulu.F.1	TGGTCACAACTGCATA	ACTCCTRCGGGAGGCAGCAG	Honolulu.F.1
Honolulu.F.10	CCACTCCTCTAGAACA	ACTCCTRCGGGAGGCAGCAG	Honolulu.F.10
Honolulu.F.11	CCACTCCTTAATCTTA	ACTCCTRCGGGAGGCAGCAG	Honolulu.F.11
Honolulu.F.12	CCACTCCTCTATTAAG	ACTCCTRCGGGAGGCAGCAG	Honolulu.F.12
Honolulu.F.2	TGGTCACACTAGAACA	ACTCCTRCGGGAGGCAGCAG	Honolulu.F.2
Honolulu.F.3	TGGTCACATAATCTTA	ACTCCTRCGGGAGGCAGCAG	Honolulu.F.3
Honolulu.F.4	TGGTCACACTATTAAG	ACTCCTRCGGGAGGCAGCAG	Honolulu.F.4
Honolulu.F.5	TTGACCCTACTGCATA	ACTCCTRCGGGAGGCAGCAG	Honolulu.F.5
Honolulu.F.6	TTGACCCTCTAGAACA	ACTCCTRCGGGAGGCAGCAG	Honolulu.F.6
Honolulu.F.7	TTGACCCTTAATCTTA	ACTCCTRCGGGAGGCAGCAG	Honolulu.F.7
Honolulu.F.8	TTGACCCTCTATTAAG	ACTCCTRCGGGAGGCAGCAG	Honolulu.F.8
Honolulu.F.9	CCACTCCTACTGCATA	ACTCCTRCGGGAGGCAGCAG	Honolulu.F.9
Honolulu.G.1	TGGTCACAAAGGAGTA	ACTCCTRCGGGAGGCAGCAG	Honolulu.G.1
Honolulu.G.10	CCACTCCTTAAGTTCC	ACTCCTRCGGGAGGCAGCAG	Honolulu.G.10
Honolulu.G.11	CCACTCCTCAGGACGT	ACTCCTRCGGGAGGCAGCAG	Honolulu.G.11
Honolulu.G.12	CCACTCCTAAGGCTAT	ACTCCTRCGGGAGGCAGCAG	Honolulu.G.12
Honolulu.G.2	TGGTCACATAAGTTCC	ACTCCTRCGGGAGGCAGCAG	Honolulu.G.2
Honolulu.G.3	TGGTCACACAGGACGT	ACTCCTRCGGGAGGCAGCAG	Honolulu.G.3
Honolulu.G.4	TGGTCACAAAGGCTAT	ACTCCTRCGGGAGGCAGCAG	Honolulu.G.4
Honolulu.G.5	TTGACCCTAAGGAGTA	ACTCCTRCGGGAGGCAGCAG	Honolulu.G.5
Honolulu.G.6	TTGACCCTTAAGTTCC	ACTCCTRCGGGAGGCAGCAG	Honolulu.G.6
Honolulu.G.7	TTGACCCTCAGGACGT	ACTCCTRCGGGAGGCAGCAG	Honolulu.G.7
Honolulu.G.8	TTGACCCTAAGGCTAT	ACTCCTRCGGGAGGCAGCAG	Honolulu.G.8
Honolulu.G.9	CCACTCCTAAGGAGTA	ACTCCTRCGGGAGGCAGCAG	Honolulu.G.9
Honolulu.H.1	TGGTCACACTAAGCCT	ACTCCTRCGGGAGGCAGCAG	Honolulu.H.1
Honolulu.H.10	CCACTCCTTAGACCTA	ACTCCTRCGGGAGGCAGCAG	Honolulu.H.10
Honolulu.H.11	CCACTCCTGTACTGAC	ACTCCTRCGGGAGGCAGCAG	Honolulu.H.11
Honolulu.H.12	CCACTCCTGAGCCTTA	ACTCCTRCGGGAGGCAGCAG	Honolulu.H.12
Honolulu.H.2	TGGTCACATAGACCTA	ACTCCTRCGGGAGGCAGCAG	Honolulu.H.2
Honolulu.H.3	TGGTCACAGTACTGAC	ACTCCTRCGGGAGGCAGCAG	Honolulu.H.3
Honolulu.H.4	TGGTCACAGAGCCTTA	ACTCCTRCGGGAGGCAGCAG	Honolulu.H.4
Honolulu.H.5	TTGACCCTCTAAGCCT	ACTCCTRCGGGAGGCAGCAG	Honolulu.H.5
Honolulu.H.6	TTGACCCTTAGACCTA	ACTCCTRCGGGAGGCAGCAG	Honolulu.H.6
Honolulu.H.7	TTGACCCTGTACTGAC	ACTCCTRCGGGAGGCAGCAG	Honolulu.H.7
Honolulu.H.8	TTGACCCTGAGCCTTA	ACTCCTRCGGGAGGCAGCAG	Honolulu.H.8
Honolulu.H.9	CCACTCCTCTAAGCCT	ACTCCTRCGGGAGGCAGCAG	Honolulu.H.9
Istanbul.A.1	CGAGTAATTAGATCGC	ACTCCTRCGGGAGGCAGCAG	Istanbul.A.1
Istanbul.A.10	AATGAGCGTGAACCTT	ACTCCTRCGGGAGGCAGCAG	Istanbul.A.10
Istanbul.A.11	AATGAGCGTATAGCCT	ACTCCTRCGGGAGGCAGCAG	Istanbul.A.11
Istanbul.A.12	AATGAGCGCGTCTAAT	ACTCCTRCGGGAGGCAGCAG	Istanbul.A.12
Istanbul.A.2	CGAGTAATTGAACCTT	ACTCCTRCGGGAGGCAGCAG	Istanbul.A.2
Istanbul.A.3	CGAGTAATTATAGCCT	ACTCCTRCGGGAGGCAGCAG	Istanbul.A.3
Istanbul.A.4	CGAGTAATCGTCTAAT	ACTCCTRCGGGAGGCAGCAG	Istanbul.A.4
Istanbul.A.5	TCTCCGGATAGATCGC	ACTCCTRCGGGAGGCAGCAG	Istanbul.A.5
Istanbul.A.6	TCTCCGGATGAACCTT	ACTCCTRCGGGAGGCAGCAG	Istanbul.A.6
Istanbul.A.7	TCTCCGGATATAGCCT	ACTCCTRCGGGAGGCAGCAG	Istanbul.A.7
Istanbul.A.8	TCTCCGGACGTCTAAT	ACTCCTRCGGGAGGCAGCAG	Istanbul.A.8
Istanbul.A.9	AATGAGCGTAGATCGC	ACTCCTRCGGGAGGCAGCAG	Istanbul.A.9
Istanbul.B.1	CGAGTAATCTCTCTAT	ACTCCTRCGGGAGGCAGCAG	Istanbul.B.1
Istanbul.B.10	AATGAGCGTGCTAAGT	ACTCCTRCGGGAGGCAGCAG	Istanbul.B.10
Istanbul.B.11	AATGAGCGATAGAGGC	ACTCCTRCGGGAGGCAGCAG	Istanbul.B.11
Istanbul.B.12	AATGAGCGTCTCTCCG	ACTCCTRCGGGAGGCAGCAG	Istanbul.B.12
Istanbul.B.2	CGAGTAATTGCTAAGT	ACTCCTRCGGGAGGCAGCAG	Istanbul.B.2
Istanbul.B.3	CGAGTAATATAGAGGC	ACTCCTRCGGGAGGCAGCAG	Istanbul.B.3
Istanbul.B.4	CGAGTAATTCTCTCCG	ACTCCTRCGGGAGGCAGCAG	Istanbul.B.4
Istanbul.B.5	TCTCCGGACTCTCTAT	ACTCCTRCGGGAGGCAGCAG	Istanbul.B.5
Istanbul.B.6	TCTCCGGATGCTAAGT	ACTCCTRCGGGAGGCAGCAG	Istanbul.B.6
Istanbul.B.7	TCTCCGGAATAGAGGC	ACTCCTRCGGGAGGCAGCAG	Istanbul.B.7
Istanbul.B.8	TCTCCGGATCTCTCCG	ACTCCTRCGGGAGGCAGCAG	Istanbul.B.8
Istanbul.B.9	AATGAGCGCTCTCTAT	ACTCCTRCGGGAGGCAGCAG	Istanbul.B.9
Istanbul.C.1	CGAGTAATTATCCTCT	ACTCCTRCGGGAGGCAGCAG	Istanbul.C.1
Istanbul.C.10	AATGAGCGTGTTCTCT	ACTCCTRCGGGAGGCAGCAG	Istanbul.C.10
Istanbul.C.11	AATGAGCGCCTATCCT	ACTCCTRCGGGAGGCAGCAG	Istanbul.C.11
Istanbul.C.12	AATGAGCGTCGACTAG	ACTCCTRCGGGAGGCAGCAG	Istanbul.C.12
Istanbul.C.2	CGAGTAATTGTTCTCT	ACTCCTRCGGGAGGCAGCAG	Istanbul.C.2
Istanbul.C.3	CGAGTAATCCTATCCT	ACTCCTRCGGGAGGCAGCAG	Istanbul.C.3
Istanbul.C.4	CGAGTAATTCGACTAG	ACTCCTRCGGGAGGCAGCAG	Istanbul.C.4
Istanbul.C.5	TCTCCGGATATCCTCT	ACTCCTRCGGGAGGCAGCAG	Istanbul.C.5
Istanbul.C.6	TCTCCGGATGTTCTCT	ACTCCTRCGGGAGGCAGCAG	Istanbul.C.6
Istanbul.C.7	TCTCCGGACCTATCCT	ACTCCTRCGGGAGGCAGCAG	Istanbul.C.7
Istanbul.C.8	TCTCCGGATCGACTAG	ACTCCTRCGGGAGGCAGCAG	Istanbul.C.8
Istanbul.C.9	AATGAGCGTATCCTCT	ACTCCTRCGGGAGGCAGCAG	Istanbul.C.9
Istanbul.D.1	CGAGTAATAGAGTAGA	ACTCCTRCGGGAGGCAGCAG	Istanbul.D.1
Istanbul.D.10	AATGAGCGTAAGACAC	ACTCCTRCGGGAGGCAGCAG	Istanbul.D.10
Istanbul.D.11	AATGAGCGGGCTCTGA	ACTCCTRCGGGAGGCAGCAG	Istanbul.D.11
Istanbul.D.12	AATGAGCGTTCTAGCT	ACTCCTRCGGGAGGCAGCAG	Istanbul.D.12
Istanbul.D.2	CGAGTAATTAAGACAC	ACTCCTRCGGGAGGCAGCAG	Istanbul.D.2
Istanbul.D.3	CGAGTAATGGCTCTGA	ACTCCTRCGGGAGGCAGCAG	Istanbul.D.3
Istanbul.D.4	CGAGTAATTTCTAGCT	ACTCCTRCGGGAGGCAGCAG	Istanbul.D.4
Istanbul.D.5	TCTCCGGAAGAGTAGA	ACTCCTRCGGGAGGCAGCAG	Istanbul.D.5
Istanbul.D.6	TCTCCGGATAAGACAC	ACTCCTRCGGGAGGCAGCAG	Istanbul.D.6
Istanbul.D.7	TCTCCGGAGGCTCTGA	ACTCCTRCGGGAGGCAGCAG	Istanbul.D.7
Istanbul.D.8	TCTCCGGATTCTAGCT	ACTCCTRCGGGAGGCAGCAG	Istanbul.D.8
Istanbul.D.9	AATGAGCGAGAGTAGA	ACTCCTRCGGGAGGCAGCAG	Istanbul.D.9
Istanbul.E.1	CGAGTAATGTAAGGAG	ACTCCTRCGGGAGGCAGCAG	Istanbul.E.1
Istanbul.E.10	AATGAGCGCTAATCGA	ACTCCTRCGGGAGGCAGCAG	Istanbul.E.10
Istanbul.E.11	AATGAGCGAGGCGAAG	ACTCCTRCGGGAGGCAGCAG	Istanbul.E.11
Istanbul.E.12	AATGAGCGCCTAGAGT	ACTCCTRCGGGAGGCAGCAG	Istanbul.E.12
Istanbul.E.2	CGAGTAATCTAATCGA	ACTCCTRCGGGAGGCAGCAG	Istanbul.E.2
Istanbul.E.3	CGAGTAATAGGCGAAG	ACTCCTRCGGGAGGCAGCAG	Istanbul.E.3
Istanbul.E.4	CGAGTAATCCTAGAGT	ACTCCTRCGGGAGGCAGCAG	Istanbul.E.4
Istanbul.E.5	TCTCCGGAGTAAGGAG	ACTCCTRCGGGAGGCAGCAG	Istanbul.E.5
Istanbul.E.6	TCTCCGGACTAATCGA	ACTCCTRCGGGAGGCAGCAG	Istanbul.E.6
Istanbul.E.7	TCTCCGGAAGGCGAAG	ACTCCTRCGGGAGGCAGCAG	Istanbul.E.7
Istanbul.E.8	TCTCCGGACCTAGAGT	ACTCCTRCGGGAGGCAGCAG	Istanbul.E.8
Istanbul.E.9	AATGAGCGGTAAGGAG	ACTCCTRCGGGAGGCAGCAG	Istanbul.E.9
Istanbul.F.1	CGAGTAATACTGCATA	ACTCCTRCGGGAGGCAGCAG	Istanbul.F.1
Istanbul.F.10	AATGAGCGCTAGAACA	ACTCCTRCGGGAGGCAGCAG	Istanbul.F.10
Istanbul.F.11	AATGAGCGTAATCTTA	ACTCCTRCGGGAGGCAGCAG	Istanbul.F.11
Istanbul.F.12	AATGAGCGCTATTAAG	ACTCCTRCGGGAGGCAGCAG	Istanbul.F.12
Istanbul.F.2	CGAGTAATCTAGAACA	ACTCCTRCGGGAGGCAGCAG	Istanbul.F.2
Istanbul.F.3	CGAGTAATTAATCTTA	ACTCCTRCGGGAGGCAGCAG	Istanbul.F.3
Istanbul.F.4	CGAGTAATCTATTAAG	ACTCCTRCGGGAGGCAGCAG	Istanbul.F.4
Istanbul.F.5	TCTCCGGAACTGCATA	ACTCCTRCGGGAGGCAGCAG	Istanbul.F.5
Istanbul.F.6	TCTCCGGACTAGAACA	ACTCCTRCGGGAGGCAGCAG	Istanbul.F.6
Istanbul.F.7	TCTCCGGATAATCTTA	ACTCCTRCGGGAGGCAGCAG	Istanbul.F.7
Istanbul.F.8	TCTCCGGACTATTAAG	ACTCCTRCGGGAGGCAGCAG	Istanbul.F.8
Istanbul.F.9	AATGAGCGACTGCATA	ACTCCTRCGGGAGGCAGCAG	Istanbul.F.9
Istanbul.G.1	CGAGTAATAAGGAGTA	ACTCCTRCGGGAGGCAGCAG	Istanbul.G.1
Istanbul.G.10	AATGAGCGTAAGTTCC	ACTCCTRCGGGAGGCAGCAG	Istanbul.G.10
Istanbul.G.11	AATGAGCGCAGGACGT	ACTCCTRCGGGAGGCAGCAG	Istanbul.G.11
Istanbul.G.12	AATGAGCGAAGGCTAT	ACTCCTRCGGGAGGCAGCAG	Istanbul.G.12
Istanbul.G.2	CGAGTAATTAAGTTCC	ACTCCTRCGGGAGGCAGCAG	Istanbul.G.2
Istanbul.G.3	CGAGTAATCAGGACGT	ACTCCTRCGGGAGGCAGCAG	Istanbul.G.3
Istanbul.G.4	CGAGTAATAAGGCTAT	ACTCCTRCGGGAGGCAGCAG	Istanbul.G.4
Istanbul.G.5	TCTCCGGAAAGGAGTA	ACTCCTRCGGGAGGCAGCAG	Istanbul.G.5
Istanbul.G.6	TCTCCGGATAAGTTCC	ACTCCTRCGGGAGGCAGCAG	Istanbul.G.6
Istanbul.G.7	TCTCCGGACAGGACGT	ACTCCTRCGGGAGGCAGCAG	Istanbul.G.7
Istanbul.G.8	TCTCCGGAAAGGCTAT	ACTCCTRCGGGAGGCAGCAG	Istanbul.G.8
Istanbul.G.9	AATGAGCGAAGGAGTA	ACTCCTRCGGGAGGCAGCAG	Istanbul.G.9
Istanbul.H.1	CGAGTAATCTAAGCCT	ACTCCTRCGGGAGGCAGCAG	Istanbul.H.1
Istanbul.H.10	AATGAGCGTAGACCTA	ACTCCTRCGGGAGGCAGCAG	Istanbul.H.10
Istanbul.H.11	AATGAGCGGTACTGAC	ACTCCTRCGGGAGGCAGCAG	Istanbul.H.11
Istanbul.H.12	AATGAGCGGAGCCTTA	ACTCCTRCGGGAGGCAGCAG	Istanbul.H.12
Istanbul.H.2	CGAGTAATTAGACCTA	ACTCCTRCGGGAGGCAGCAG	Istanbul.H.2
Istanbul.H.3	CGAGTAATGTACTGAC	ACTCCTRCGGGAGGCAGCAG	Istanbul.H.3
Istanbul.H.4	CGAGTAATGAGCCTTA	ACTCCTRCGGGAGGCAGCAG	Istanbul.H.4
Istanbul.H.5	TCTCCGGACTAAGCCT	ACTCCTRCGGGAGGCAGCAG	Istanbul.H.5
Istanbul.H.6	TCTCCGGATAGACCTA	ACTCCTRCGGGAGGCAGCAG	Istanbul.H.6
Istanbul.H.7	TCTCCGGAGTACTGAC	ACTCCTRCGGGAGGCAGCAG	Istanbul.H.7
Istanbul.H.8	TCTCCGGAGAGCCTTA	ACTCCTRCGGGAGGCAGCAG	Istanbul.H.8
Istanbul.H.9	AATGAGCGCTAAGCCT	ACTCCTRCGGGAGGCAGCAG	Istanbul.H.9
Jakarta.A.1	GGAATCTCTAGATCGC	ACTCCTRCGGGAGGCAGCAG	Jakarta.A.1
Jakarta.A.10	ACGAATTCTGAACCTT	ACTCCTRCGGGAGGCAGCAG	Jakarta.A.10
Jakarta.A.11	ACGAATTCTATAGCCT	ACTCCTRCGGGAGGCAGCAG	Jakarta.A.11
Jakarta.A.12	ACGAATTCCGTCTAAT	ACTCCTRCGGGAGGCAGCAG	Jakarta.A.12
Jakarta.A.2	GGAATCTCTGAACCTT	ACTCCTRCGGGAGGCAGCAG	Jakarta.A.2
Jakarta.A.3	GGAATCTCTATAGCCT	ACTCCTRCGGGAGGCAGCAG	Jakarta.A.3
Jakarta.A.4	GGAATCTCCGTCTAAT	ACTCCTRCGGGAGGCAGCAG	Jakarta.A.4
Jakarta.A.5	TTCTGAATTAGATCGC	ACTCCTRCGGGAGGCAGCAG	Jakarta.A.5
Jakarta.A.6	TTCTGAATTGAACCTT	ACTCCTRCGGGAGGCAGCAG	Jakarta.A.6
Jakarta.A.7	TTCTGAATTATAGCCT	ACTCCTRCGGGAGGCAGCAG	Jakarta.A.7
Jakarta.A.8	TTCTGAATCGTCTAAT	ACTCCTRCGGGAGGCAGCAG	Jakarta.A.8
Jakarta.A.9	ACGAATTCTAGATCGC	ACTCCTRCGGGAGGCAGCAG	Jakarta.A.9
Jakarta.B.1	GGAATCTCCTCTCTAT	ACTCCTRCGGGAGGCAGCAG	Jakarta.B.1
Jakarta.B.10	ACGAATTCTGCTAAGT	ACTCCTRCGGGAGGCAGCAG	Jakarta.B.10
Jakarta.B.11	ACGAATTCATAGAGGC	ACTCCTRCGGGAGGCAGCAG	Jakarta.B.11
Jakarta.B.12	ACGAATTCTCTCTCCG	ACTCCTRCGGGAGGCAGCAG	Jakarta.B.12
Jakarta.B.2	GGAATCTCTGCTAAGT	ACTCCTRCGGGAGGCAGCAG	Jakarta.B.2
Jakarta.B.3	GGAATCTCATAGAGGC	ACTCCTRCGGGAGGCAGCAG	Jakarta.B.3
Jakarta.B.4	GGAATCTCTCTCTCCG	ACTCCTRCGGGAGGCAGCAG	Jakarta.B.4
Jakarta.B.5	TTCTGAATCTCTCTAT	ACTCCTRCGGGAGGCAGCAG	Jakarta.B.5
Jakarta.B.6	TTCTGAATTGCTAAGT	ACTCCTRCGGGAGGCAGCAG	Jakarta.B.6
Jakarta.B.7	TTCTGAATATAGAGGC	ACTCCTRCGGGAGGCAGCAG	Jakarta.B.7
Jakarta.B.8	TTCTGAATTCTCTCCG	ACTCCTRCGGGAGGCAGCAG	Jakarta.B.8
Jakarta.B.9	ACGAATTCCTCTCTAT	ACTCCTRCGGGAGGCAGCAG	Jakarta.B.9
Jakarta.C.1	GGAATCTCTATCCTCT	ACTCCTRCGGGAGGCAGCAG	Jakarta.C.1
Jakarta.C.10	ACGAATTCTGTTCTCT	ACTCCTRCGGGAGGCAGCAG	Jakarta.C.10
Jakarta.C.11	ACGAATTCCCTATCCT	ACTCCTRCGGGAGGCAGCAG	Jakarta.C.11
Jakarta.C.12	ACGAATTCTCGACTAG	ACTCCTRCGGGAGGCAGCAG	Jakarta.C.12
Jakarta.C.2	GGAATCTCTGTTCTCT	ACTCCTRCGGGAGGCAGCAG	Jakarta.C.2
Jakarta.C.3	GGAATCTCCCTATCCT	ACTCCTRCGGGAGGCAGCAG	Jakarta.C.3
Jakarta.C.4	GGAATCTCTCGACTAG	ACTCCTRCGGGAGGCAGCAG	Jakarta.C.4
Jakarta.C.5	TTCTGAATTATCCTCT	ACTCCTRCGGGAGGCAGCAG	Jakarta.C.5
Jakarta.C.6	TTCTGAATTGTTCTCT	ACTCCTRCGGGAGGCAGCAG	Jakarta.C.6
Jakarta.C.7	TTCTGAATCCTATCCT	ACTCCTRCGGGAGGCAGCAG	Jakarta.C.7
Jakarta.C.8	TTCTGAATTCGACTAG	ACTCCTRCGGGAGGCAGCAG	Jakarta.C.8
Jakarta.C.9	ACGAATTCTATCCTCT	ACTCCTRCGGGAGGCAGCAG	Jakarta.C.9
Jakarta.D.1	GGAATCTCAGAGTAGA	ACTCCTRCGGGAGGCAGCAG	Jakarta.D.1
Jakarta.D.10	ACGAATTCTAAGACAC	ACTCCTRCGGGAGGCAGCAG	Jakarta.D.10
Jakarta.D.11	ACGAATTCGGCTCTGA	ACTCCTRCGGGAGGCAGCAG	Jakarta.D.11
Jakarta.D.12	ACGAATTCTTCTAGCT	ACTCCTRCGGGAGGCAGCAG	Jakarta.D.12
Jakarta.D.2	GGAATCTCTAAGACAC	ACTCCTRCGGGAGGCAGCAG	Jakarta.D.2
Jakarta.D.3	GGAATCTCGGCTCTGA	ACTCCTRCGGGAGGCAGCAG	Jakarta.D.3
Jakarta.D.4	GGAATCTCTTCTAGCT	ACTCCTRCGGGAGGCAGCAG	Jakarta.D.4
Jakarta.D.5	TTCTGAATAGAGTAGA	ACTCCTRCGGGAGGCAGCAG	Jakarta.D.5
Jakarta.D.6	TTCTGAATTAAGACAC	ACTCCTRCGGGAGGCAGCAG	Jakarta.D.6
Jakarta.D.7	TTCTGAATGGCTCTGA	ACTCCTRCGGGAGGCAGCAG	Jakarta.D.7
Jakarta.D.8	TTCTGAATTTCTAGCT	ACTCCTRCGGGAGGCAGCAG	Jakarta.D.8
Jakarta.D.9	ACGAATTCAGAGTAGA	ACTCCTRCGGGAGGCAGCAG	Jakarta.D.9
Jakarta.E.1	GGAATCTCGTAAGGAG	ACTCCTRCGGGAGGCAGCAG	Jakarta.E.1
Jakarta.E.10	ACGAATTCCTAATCGA	ACTCCTRCGGGAGGCAGCAG	Jakarta.E.10
Jakarta.E.11	ACGAATTCAGGCGAAG	ACTCCTRCGGGAGGCAGCAG	Jakarta.E.11
Jakarta.E.12	ACGAATTCCCTAGAGT	ACTCCTRCGGGAGGCAGCAG	Jakarta.E.12
Jakarta.E.2	GGAATCTCCTAATCGA	ACTCCTRCGGGAGGCAGCAG	Jakarta.E.2
Jakarta.E.3	GGAATCTCAGGCGAAG	ACTCCTRCGGGAGGCAGCAG	Jakarta.E.3
Jakarta.E.4	GGAATCTCCCTAGAGT	ACTCCTRCGGGAGGCAGCAG	Jakarta.E.4
Jakarta.E.5	TTCTGAATGTAAGGAG	ACTCCTRCGGGAGGCAGCAG	Jakarta.E.5
Jakarta.E.6	TTCTGAATCTAATCGA	ACTCCTRCGGGAGGCAGCAG	Jakarta.E.6
Jakarta.E.7	TTCTGAATAGGCGAAG	ACTCCTRCGGGAGGCAGCAG	Jakarta.E.7
Jakarta.E.8	TTCTGAATCCTAGAGT	ACTCCTRCGGGAGGCAGCAG	Jakarta.E.8
Jakarta.E.9	ACGAATTCGTAAGGAG	ACTCCTRCGGGAGGCAGCAG	Jakarta.E.9
Jakarta.F.1	GGAATCTCACTGCATA	ACTCCTRCGGGAGGCAGCAG	Jakarta.F.1
Jakarta.F.10	ACGAATTCCTAGAACA	ACTCCTRCGGGAGGCAGCAG	Jakarta.F.10
Jakarta.F.11	ACGAATTCTAATCTTA	ACTCCTRCGGGAGGCAGCAG	Jakarta.F.11
Jakarta.F.12	ACGAATTCCTATTAAG	ACTCCTRCGGGAGGCAGCAG	Jakarta.F.12
Jakarta.F.2	GGAATCTCCTAGAACA	ACTCCTRCGGGAGGCAGCAG	Jakarta.F.2
Jakarta.F.3	GGAATCTCTAATCTTA	ACTCCTRCGGGAGGCAGCAG	Jakarta.F.3
Jakarta.F.4	GGAATCTCCTATTAAG	ACTCCTRCGGGAGGCAGCAG	Jakarta.F.4
Jakarta.F.5	TTCTGAATACTGCATA	ACTCCTRCGGGAGGCAGCAG	Jakarta.F.5
Jakarta.F.6	TTCTGAATCTAGAACA	ACTCCTRCGGGAGGCAGCAG	Jakarta.F.6
Jakarta.F.7	TTCTGAATTAATCTTA	ACTCCTRCGGGAGGCAGCAG	Jakarta.F.7
Jakarta.F.8	TTCTGAATCTATTAAG	ACTCCTRCGGGAGGCAGCAG	Jakarta.F.8
Jakarta.F.9	ACGAATTCACTGCATA	ACTCCTRCGGGAGGCAGCAG	Jakarta.F.9
Jakarta.G.1	GGAATCTCAAGGAGTA	ACTCCTRCGGGAGGCAGCAG	Jakarta.G.1
Jakarta.G.10	ACGAATTCTAAGTTCC	ACTCCTRCGGGAGGCAGCAG	Jakarta.G.10
Jakarta.G.11	ACGAATTCCAGGACGT	ACTCCTRCGGGAGGCAGCAG	Jakarta.G.11
Jakarta.G.12	ACGAATTCAAGGCTAT	ACTCCTRCGGGAGGCAGCAG	Jakarta.G.12
Jakarta.G.2	GGAATCTCTAAGTTCC	ACTCCTRCGGGAGGCAGCAG	Jakarta.G.2
Jakarta.G.3	GGAATCTCCAGGACGT	ACTCCTRCGGGAGGCAGCAG	Jakarta.G.3
Jakarta.G.4	GGAATCTCAAGGCTAT	ACTCCTRCGGGAGGCAGCAG	Jakarta.G.4
Jakarta.G.5	TTCTGAATAAGGAGTA	ACTCCTRCGGGAGGCAGCAG	Jakarta.G.5
Jakarta.G.6	TTCTGAATTAAGTTCC	ACTCCTRCGGGAGGCAGCAG	Jakarta.G.6
Jakarta.G.7	TTCTGAATCAGGACGT	ACTCCTRCGGGAGGCAGCAG	Jakarta.G.7
Jakarta.G.8	TTCTGAATAAGGCTAT	ACTCCTRCGGGAGGCAGCAG	Jakarta.G.8
Jakarta.G.9	ACGAATTCAAGGAGTA	ACTCCTRCGGGAGGCAGCAG	Jakarta.G.9
Jakarta.H.1	GGAATCTCCTAAGCCT	ACTCCTRCGGGAGGCAGCAG	Jakarta.H.1
Jakarta.H.10	ACGAATTCTAGACCTA	ACTCCTRCGGGAGGCAGCAG	Jakarta.H.10
Jakarta.H.11	ACGAATTCGTACTGAC	ACTCCTRCGGGAGGCAGCAG	Jakarta.H.11
Jakarta.H.12	ACGAATTCGAGCCTTA	ACTCCTRCGGGAGGCAGCAG	Jakarta.H.12
Jakarta.H.2	GGAATCTCTAGACCTA	ACTCCTRCGGGAGGCAGCAG	Jakarta.H.2
Jakarta.H.3	GGAATCTCGTACTGAC	ACTCCTRCGGGAGGCAGCAG	Jakarta.H.3
Jakarta.H.4	GGAATCTCGAGCCTTA	ACTCCTRCGGGAGGCAGCAG	Jakarta.H.4
Jakarta.H.5	TTCTGAATCTAAGCCT	ACTCCTRCGGGAGGCAGCAG	Jakarta.H.5
Jakarta.H.6	TTCTGAATTAGACCTA	ACTCCTRCGGGAGGCAGCAG	Jakarta.H.6
Jakarta.H.7	TTCTGAATGTACTGAC	ACTCCTRCGGGAGGCAGCAG	Jakarta.H.7
Jakarta.H.8	TTCTGAATGAGCCTTA	ACTCCTRCGGGAGGCAGCAG	Jakarta.H.8
Jakarta.H.9	ACGAATTCCTAAGCCT	ACTCCTRCGGGAGGCAGCAG	Jakarta.H.9
Kyoto.A.1	AGCTTCAGTAGATCGC	ACTCCTRCGGGAGGCAGCAG	Kyoto.A.1
Kyoto.A.10	CATAGCCGTGAACCTT	ACTCCTRCGGGAGGCAGCAG	Kyoto.A.10
Kyoto.A.11	CATAGCCGTATAGCCT	ACTCCTRCGGGAGGCAGCAG	Kyoto.A.11
Kyoto.A.12	CATAGCCGCGTCTAAT	ACTCCTRCGGGAGGCAGCAG	Kyoto.A.12
Kyoto.A.2	AGCTTCAGTGAACCTT	ACTCCTRCGGGAGGCAGCAG	Kyoto.A.2
Kyoto.A.3	AGCTTCAGTATAGCCT	ACTCCTRCGGGAGGCAGCAG	Kyoto.A.3
Kyoto.A.4	AGCTTCAGCGTCTAAT	ACTCCTRCGGGAGGCAGCAG	Kyoto.A.4
Kyoto.A.5	GCGCATTATAGATCGC	ACTCCTRCGGGAGGCAGCAG	Kyoto.A.5
Kyoto.A.6	GCGCATTATGAACCTT	ACTCCTRCGGGAGGCAGCAG	Kyoto.A.6
Kyoto.A.7	GCGCATTATATAGCCT	ACTCCTRCGGGAGGCAGCAG	Kyoto.A.7
Kyoto.A.8	GCGCATTACGTCTAAT	ACTCCTRCGGGAGGCAGCAG	Kyoto.A.8
Kyoto.A.9	CATAGCCGTAGATCGC	ACTCCTRCGGGAGGCAGCAG	Kyoto.A.9
Kyoto.B.1	AGCTTCAGCTCTCTAT	ACTCCTRCGGGAGGCAGCAG	Kyoto.B.1
Kyoto.B.10	CATAGCCGTGCTAAGT	ACTCCTRCGGGAGGCAGCAG	Kyoto.B.10
Kyoto.B.11	CATAGCCGATAGAGGC	ACTCCTRCGGGAGGCAGCAG	Kyoto.B.11
Kyoto.B.12	CATAGCCGTCTCTCCG	ACTCCTRCGGGAGGCAGCAG	Kyoto.B.12
Kyoto.B.2	AGCTTCAGTGCTAAGT	ACTCCTRCGGGAGGCAGCAG	Kyoto.B.2
Kyoto.B.3	AGCTTCAGATAGAGGC	ACTCCTRCGGGAGGCAGCAG	Kyoto.B.3
Kyoto.B.4	AGCTTCAGTCTCTCCG	ACTCCTRCGGGAGGCAGCAG	Kyoto.B.4
Kyoto.B.5	GCGCATTACTCTCTAT	ACTCCTRCGGGAGGCAGCAG	Kyoto.B.5
Kyoto.B.6	GCGCATTATGCTAAGT	ACTCCTRCGGGAGGCAGCAG	Kyoto.B.6
Kyoto.B.7	GCGCATTAATAGAGGC	ACTCCTRCGGGAGGCAGCAG	Kyoto.B.7
Kyoto.B.8	GCGCATTATCTCTCCG	ACTCCTRCGGGAGGCAGCAG	Kyoto.B.8
Kyoto.B.9	CATAGCCGCTCTCTAT	ACTCCTRCGGGAGGCAGCAG	Kyoto.B.9
Kyoto.C.1	AGCTTCAGTATCCTCT	ACTCCTRCGGGAGGCAGCAG	Kyoto.C.1
Kyoto.C.10	CATAGCCGTGTTCTCT	ACTCCTRCGGGAGGCAGCAG	Kyoto.C.10
Kyoto.C.11	CATAGCCGCCTATCCT	ACTCCTRCGGGAGGCAGCAG	Kyoto.C.11
Kyoto.C.12	CATAGCCGTCGACTAG	ACTCCTRCGGGAGGCAGCAG	Kyoto.C.12
Kyoto.C.2	AGCTTCAGTGTTCTCT	ACTCCTRCGGGAGGCAGCAG	Kyoto.C.2
Kyoto.C.3	AGCTTCAGCCTATCCT	ACTCCTRCGGGAGGCAGCAG	Kyoto.C.3
Kyoto.C.4	AGCTTCAGTCGACTAG	ACTCCTRCGGGAGGCAGCAG	Kyoto.C.4
Kyoto.C.5	GCGCATTATATCCTCT	ACTCCTRCGGGAGGCAGCAG	Kyoto.C.5
Kyoto.C.6	GCGCATTATGTTCTCT	ACTCCTRCGGGAGGCAGCAG	Kyoto.C.6
Kyoto.C.7	GCGCATTACCTATCCT	ACTCCTRCGGGAGGCAGCAG	Kyoto.C.7
Kyoto.C.8	GCGCATTATCGACTAG	ACTCCTRCGGGAGGCAGCAG	Kyoto.C.8
Kyoto.C.9	CATAGCCGTATCCTCT	ACTCCTRCGGGAGGCAGCAG	Kyoto.C.9
Kyoto.D.1	AGCTTCAGAGAGTAGA	ACTCCTRCGGGAGGCAGCAG	Kyoto.D.1
Kyoto.D.10	CATAGCCGTAAGACAC	ACTCCTRCGGGAGGCAGCAG	Kyoto.D.10
Kyoto.D.11	CATAGCCGGGCTCTGA	ACTCCTRCGGGAGGCAGCAG	Kyoto.D.11
Kyoto.D.12	CATAGCCGTTCTAGCT	ACTCCTRCGGGAGGCAGCAG	Kyoto.D.12
Kyoto.D.2	AGCTTCAGTAAGACAC	ACTCCTRCGGGAGGCAGCAG	Kyoto.D.2
Kyoto.D.3	AGCTTCAGGGCTCTGA	ACTCCTRCGGGAGGCAGCAG	Kyoto.D.3
Kyoto.D.4	AGCTTCAGTTCTAGCT	ACTCCTRCGGGAGGCAGCAG	Kyoto.D.4
Kyoto.D.5	GCGCATTAAGAGTAGA	ACTCCTRCGGGAGGCAGCAG	Kyoto.D.5
Kyoto.D.6	GCGCATTATAAGACAC	ACTCCTRCGGGAGGCAGCAG	Kyoto.D.6
Kyoto.D.7	GCGCATTAGGCTCTGA	ACTCCTRCGGGAGGCAGCAG	Kyoto.D.7
Kyoto.D.8	GCGCATTATTCTAGCT	ACTCCTRCGGGAGGCAGCAG	Kyoto.D.8
Kyoto.D.9	CATAGCCGAGAGTAGA	ACTCCTRCGGGAGGCAGCAG	Kyoto.D.9
Kyoto.E.1	AGCTTCAGGTAAGGAG	ACTCCTRCGGGAGGCAGCAG	Kyoto.E.1
Kyoto.E.10	CATAGCCGCTAATCGA	ACTCCTRCGGGAGGCAGCAG	Kyoto.E.10
Kyoto.E.11	CATAGCCGAGGCGAAG	ACTCCTRCGGGAGGCAGCAG	Kyoto.E.11
Kyoto.E.12	CATAGCCGCCTAGAGT	ACTCCTRCGGGAGGCAGCAG	Kyoto.E.12
Kyoto.E.2	AGCTTCAGCTAATCGA	ACTCCTRCGGGAGGCAGCAG	Kyoto.E.2
Kyoto.E.3	AGCTTCAGAGGCGAAG	ACTCCTRCGGGAGGCAGCAG	Kyoto.E.3
Kyoto.E.4	AGCTTCAGCCTAGAGT	ACTCCTRCGGGAGGCAGCAG	Kyoto.E.4
Kyoto.E.5	GCGCATTAGTAAGGAG	ACTCCTRCGGGAGGCAGCAG	Kyoto.E.5
Kyoto.E.6	GCGCATTACTAATCGA	ACTCCTRCGGGAGGCAGCAG	Kyoto.E.6
Kyoto.E.7	GCGCATTAAGGCGAAG	ACTCCTRCGGGAGGCAGCAG	Kyoto.E.7
Kyoto.E.8	GCGCATTACCTAGAGT	ACTCCTRCGGGAGGCAGCAG	Kyoto.E.8
Kyoto.E.9	CATAGCCGGTAAGGAG	ACTCCTRCGGGAGGCAGCAG	Kyoto.E.9
Kyoto.F.1	AGCTTCAGACTGCATA	ACTCCTRCGGGAGGCAGCAG	Kyoto.F.1
Kyoto.F.10	CATAGCCGCTAGAACA	ACTCCTRCGGGAGGCAGCAG	Kyoto.F.10
Kyoto.F.11	CATAGCCGTAATCTTA	ACTCCTRCGGGAGGCAGCAG	Kyoto.F.11
Kyoto.F.12	CATAGCCGCTATTAAG	ACTCCTRCGGGAGGCAGCAG	Kyoto.F.12
Kyoto.F.2	AGCTTCAGCTAGAACA	ACTCCTRCGGGAGGCAGCAG	Kyoto.F.2
Kyoto.F.3	AGCTTCAGTAATCTTA	ACTCCTRCGGGAGGCAGCAG	Kyoto.F.3
Kyoto.F.4	AGCTTCAGCTATTAAG	ACTCCTRCGGGAGGCAGCAG	Kyoto.F.4
Kyoto.F.5	GCGCATTAACTGCATA	ACTCCTRCGGGAGGCAGCAG	Kyoto.F.5
Kyoto.F.6	GCGCATTACTAGAACA	ACTCCTRCGGGAGGCAGCAG	Kyoto.F.6
Kyoto.F.7	GCGCATTATAATCTTA	ACTCCTRCGGGAGGCAGCAG	Kyoto.F.7
Kyoto.F.8	GCGCATTACTATTAAG	ACTCCTRCGGGAGGCAGCAG	Kyoto.F.8
Kyoto.F.9	CATAGCCGACTGCATA	ACTCCTRCGGGAGGCAGCAG	Kyoto.F.9
Kyoto.G.1	AGCTTCAGAAGGAGTA	ACTCCTRCGGGAGGCAGCAG	Kyoto.G.1
Kyoto.G.10	CATAGCCGTAAGTTCC	ACTCCTRCGGGAGGCAGCAG	Kyoto.G.10
Kyoto.G.11	CATAGCCGCAGGACGT	ACTCCTRCGGGAGGCAGCAG	Kyoto.G.11
Kyoto.G.12	CATAGCCGAAGGCTAT	ACTCCTRCGGGAGGCAGCAG	Kyoto.G.12
Kyoto.G.2	AGCTTCAGTAAGTTCC	ACTCCTRCGGGAGGCAGCAG	Kyoto.G.2
Kyoto.G.3	AGCTTCAGCAGGACGT	ACTCCTRCGGGAGGCAGCAG	Kyoto.G.3
Kyoto.G.4	AGCTTCAGAAGGCTAT	ACTCCTRCGGGAGGCAGCAG	Kyoto.G.4
Kyoto.G.5	GCGCATTAAAGGAGTA	ACTCCTRCGGGAGGCAGCAG	Kyoto.G.5
Kyoto.G.6	GCGCATTATAAGTTCC	ACTCCTRCGGGAGGCAGCAG	Kyoto.G.6
Kyoto.G.7	GCGCATTACAGGACGT	ACTCCTRCGGGAGGCAGCAG	Kyoto.G.7
Kyoto.G.8	GCGCATTAAAGGCTAT	ACTCCTRCGGGAGGCAGCAG	Kyoto.G.8
Kyoto.G.9	CATAGCCGAAGGAGTA	ACTCCTRCGGGAGGCAGCAG	Kyoto.G.9
Kyoto.H.1	AGCTTCAGCTAAGCCT	ACTCCTRCGGGAGGCAGCAG	Kyoto.H.1
Kyoto.H.10	CATAGCCGTAGACCTA	ACTCCTRCGGGAGGCAGCAG	Kyoto.H.10
Kyoto.H.11	CATAGCCGGTACTGAC	ACTCCTRCGGGAGGCAGCAG	Kyoto.H.11
Kyoto.H.12	CATAGCCGGAGCCTTA	ACTCCTRCGGGAGGCAGCAG	Kyoto.H.12
Kyoto.H.2	AGCTTCAGTAGACCTA	ACTCCTRCGGGAGGCAGCAG	Kyoto.H.2
Kyoto.H.3	AGCTTCAGGTACTGAC	ACTCCTRCGGGAGGCAGCAG	Kyoto.H.3
Kyoto.H.4	AGCTTCAGGAGCCTTA	ACTCCTRCGGGAGGCAGCAG	Kyoto.H.4
Kyoto.H.5	GCGCATTACTAAGCCT	ACTCCTRCGGGAGGCAGCAG	Kyoto.H.5
Kyoto.H.6	GCGCATTATAGACCTA	ACTCCTRCGGGAGGCAGCAG	Kyoto.H.6
Kyoto.H.7	GCGCATTAGTACTGAC	ACTCCTRCGGGAGGCAGCAG	Kyoto.H.7
Kyoto.H.8	GCGCATTAGAGCCTTA	ACTCCTRCGGGAGGCAGCAG	Kyoto.H.8
Kyoto.H.9	CATAGCCGCTAAGCCT	ACTCCTRCGGGAGGCAGCAG	Kyoto.H.9
London.A.1	TTCGCGGATAGATCGC	ACTCCTRCGGGAGGCAGCAG	London.A.1
London.A.10	CTATCGCTTGAACCTT	ACTCCTRCGGGAGGCAGCAG	London.A.10
London.A.11	CTATCGCTTATAGCCT	ACTCCTRCGGGAGGCAGCAG	London.A.11
London.A.12	CTATCGCTCGTCTAAT	ACTCCTRCGGGAGGCAGCAG	London.A.12
London.A.2	TTCGCGGATGAACCTT	ACTCCTRCGGGAGGCAGCAG	London.A.2
London.A.3	TTCGCGGATATAGCCT	ACTCCTRCGGGAGGCAGCAG	London.A.3
London.A.4	TTCGCGGACGTCTAAT	ACTCCTRCGGGAGGCAGCAG	London.A.4
London.A.5	GCGCGAGATAGATCGC	ACTCCTRCGGGAGGCAGCAG	London.A.5
London.A.6	GCGCGAGATGAACCTT	ACTCCTRCGGGAGGCAGCAG	London.A.6
London.A.7	GCGCGAGATATAGCCT	ACTCCTRCGGGAGGCAGCAG	London.A.7
London.A.8	GCGCGAGACGTCTAAT	ACTCCTRCGGGAGGCAGCAG	London.A.8
London.A.9	CTATCGCTTAGATCGC	ACTCCTRCGGGAGGCAGCAG	London.A.9
London.B.1	TTCGCGGACTCTCTAT	ACTCCTRCGGGAGGCAGCAG	London.B.1
London.B.10	CTATCGCTTGCTAAGT	ACTCCTRCGGGAGGCAGCAG	London.B.10
London.B.11	CTATCGCTATAGAGGC	ACTCCTRCGGGAGGCAGCAG	London.B.11
London.B.12	CTATCGCTTCTCTCCG	ACTCCTRCGGGAGGCAGCAG	London.B.12
London.B.2	TTCGCGGATGCTAAGT	ACTCCTRCGGGAGGCAGCAG	London.B.2
London.B.3	TTCGCGGAATAGAGGC	ACTCCTRCGGGAGGCAGCAG	London.B.3
London.B.4	TTCGCGGATCTCTCCG	ACTCCTRCGGGAGGCAGCAG	London.B.4
London.B.5	GCGCGAGACTCTCTAT	ACTCCTRCGGGAGGCAGCAG	London.B.5
London.B.6	GCGCGAGATGCTAAGT	ACTCCTRCGGGAGGCAGCAG	London.B.6
London.B.7	GCGCGAGAATAGAGGC	ACTCCTRCGGGAGGCAGCAG	London.B.7
London.B.8	GCGCGAGATCTCTCCG	ACTCCTRCGGGAGGCAGCAG	London.B.8
London.B.9	CTATCGCTCTCTCTAT	ACTCCTRCGGGAGGCAGCAG	London.B.9
London.C.1	TTCGCGGATATCCTCT	ACTCCTRCGGGAGGCAGCAG	London.C.1
London.C.10	CTATCGCTTGTTCTCT	ACTCCTRCGGGAGGCAGCAG	London.C.10
London.C.11	CTATCGCTCCTATCCT	ACTCCTRCGGGAGGCAGCAG	London.C.11
London.C.12	CTATCGCTTCGACTAG	ACTCCTRCGGGAGGCAGCAG	London.C.12
London.C.2	TTCGCGGATGTTCTCT	ACTCCTRCGGGAGGCAGCAG	London.C.2
London.C.3	TTCGCGGACCTATCCT	ACTCCTRCGGGAGGCAGCAG	London.C.3
London.C.4	TTCGCGGATCGACTAG	ACTCCTRCGGGAGGCAGCAG	London.C.4
London.C.5	GCGCGAGATATCCTCT	ACTCCTRCGGGAGGCAGCAG	London.C.5
London.C.6	GCGCGAGATGTTCTCT	ACTCCTRCGGGAGGCAGCAG	London.C.6
London.C.7	GCGCGAGACCTATCCT	ACTCCTRCGGGAGGCAGCAG	London.C.7
London.C.8	GCGCGAGATCGACTAG	ACTCCTRCGGGAGGCAGCAG	London.C.8
London.C.9	CTATCGCTTATCCTCT	ACTCCTRCGGGAGGCAGCAG	London.C.9
London.D.1	TTCGCGGAAGAGTAGA	ACTCCTRCGGGAGGCAGCAG	London.D.1
London.D.10	CTATCGCTTAAGACAC	ACTCCTRCGGGAGGCAGCAG	London.D.10
London.D.11	CTATCGCTGGCTCTGA	ACTCCTRCGGGAGGCAGCAG	London.D.11
London.D.12	CTATCGCTTTCTAGCT	ACTCCTRCGGGAGGCAGCAG	London.D.12
London.D.2	TTCGCGGATAAGACAC	ACTCCTRCGGGAGGCAGCAG	London.D.2
London.D.3	TTCGCGGAGGCTCTGA	ACTCCTRCGGGAGGCAGCAG	London.D.3
London.D.4	TTCGCGGATTCTAGCT	ACTCCTRCGGGAGGCAGCAG	London.D.4
London.D.5	GCGCGAGAAGAGTAGA	ACTCCTRCGGGAGGCAGCAG	London.D.5
London.D.6	GCGCGAGATAAGACAC	ACTCCTRCGGGAGGCAGCAG	London.D.6
London.D.7	GCGCGAGAGGCTCTGA	ACTCCTRCGGGAGGCAGCAG	London.D.7
London.D.8	GCGCGAGATTCTAGCT	ACTCCTRCGGGAGGCAGCAG	London.D.8
London.D.9	CTATCGCTAGAGTAGA	ACTCCTRCGGGAGGCAGCAG	London.D.9
London.E.1	TTCGCGGAGTAAGGAG	ACTCCTRCGGGAGGCAGCAG	London.E.1
London.E.10	CTATCGCTCTAATCGA	ACTCCTRCGGGAGGCAGCAG	London.E.10
London.E.11	CTATCGCTAGGCGAAG	ACTCCTRCGGGAGGCAGCAG	London.E.11
London.E.12	CTATCGCTCCTAGAGT	ACTCCTRCGGGAGGCAGCAG	London.E.12
London.E.2	TTCGCGGACTAATCGA	ACTCCTRCGGGAGGCAGCAG	London.E.2
London.E.3	TTCGCGGAAGGCGAAG	ACTCCTRCGGGAGGCAGCAG	London.E.3
London.E.4	TTCGCGGACCTAGAGT	ACTCCTRCGGGAGGCAGCAG	London.E.4
London.E.5	GCGCGAGAGTAAGGAG	ACTCCTRCGGGAGGCAGCAG	London.E.5
London.E.6	GCGCGAGACTAATCGA	ACTCCTRCGGGAGGCAGCAG	London.E.6
London.E.7	GCGCGAGAAGGCGAAG	ACTCCTRCGGGAGGCAGCAG	London.E.7
London.E.8	GCGCGAGACCTAGAGT	ACTCCTRCGGGAGGCAGCAG	London.E.8
London.E.9	CTATCGCTGTAAGGAG	ACTCCTRCGGGAGGCAGCAG	London.E.9
London.F.1	TTCGCGGAACTGCATA	ACTCCTRCGGGAGGCAGCAG	London.F.1
London.F.10	CTATCGCTCTAGAACA	ACTCCTRCGGGAGGCAGCAG	London.F.10
London.F.11	CTATCGCTTAATCTTA	ACTCCTRCGGGAGGCAGCAG	London.F.11
London.F.12	CTATCGCTCTATTAAG	ACTCCTRCGGGAGGCAGCAG	London.F.12
London.F.2	TTCGCGGACTAGAACA	ACTCCTRCGGGAGGCAGCAG	London.F.2
London.F.3	TTCGCGGATAATCTTA	ACTCCTRCGGGAGGCAGCAG	London.F.3
London.F.4	TTCGCGGACTATTAAG	ACTCCTRCGGGAGGCAGCAG	London.F.4
London.F.5	GCGCGAGAACTGCATA	ACTCCTRCGGGAGGCAGCAG	London.F.5
London.F.6	GCGCGAGACTAGAACA	ACTCCTRCGGGAGGCAGCAG	London.F.6
London.F.7	GCGCGAGATAATCTTA	ACTCCTRCGGGAGGCAGCAG	London.F.7
London.F.8	GCGCGAGACTATTAAG	ACTCCTRCGGGAGGCAGCAG	London.F.8
London.F.9	CTATCGCTACTGCATA	ACTCCTRCGGGAGGCAGCAG	London.F.9
London.G.1	TTCGCGGAAAGGAGTA	ACTCCTRCGGGAGGCAGCAG	London.G.1
London.G.10	CTATCGCTTAAGTTCC	ACTCCTRCGGGAGGCAGCAG	London.G.10
London.G.11	CTATCGCTCAGGACGT	ACTCCTRCGGGAGGCAGCAG	London.G.11
London.G.12	CTATCGCTAAGGCTAT	ACTCCTRCGGGAGGCAGCAG	London.G.12
London.G.2	TTCGCGGATAAGTTCC	ACTCCTRCGGGAGGCAGCAG	London.G.2
London.G.3	TTCGCGGACAGGACGT	ACTCCTRCGGGAGGCAGCAG	London.G.3
London.G.4	TTCGCGGAAAGGCTAT	ACTCCTRCGGGAGGCAGCAG	London.G.4
London.G.5	GCGCGAGAAAGGAGTA	ACTCCTRCGGGAGGCAGCAG	London.G.5
London.G.6	GCGCGAGATAAGTTCC	ACTCCTRCGGGAGGCAGCAG	London.G.6
London.G.7	GCGCGAGACAGGACGT	ACTCCTRCGGGAGGCAGCAG	London.G.7
London.G.8	GCGCGAGAAAGGCTAT	ACTCCTRCGGGAGGCAGCAG	London.G.8
London.G.9	CTATCGCTAAGGAGTA	ACTCCTRCGGGAGGCAGCAG	London.G.9
London.H.1	TTCGCGGACTAAGCCT	ACTCCTRCGGGAGGCAGCAG	London.H.1
London.H.10	CTATCGCTTAGACCTA	ACTCCTRCGGGAGGCAGCAG	London.H.10
London.H.11	CTATCGCTGTACTGAC	ACTCCTRCGGGAGGCAGCAG	London.H.11
London.H.12	CTATCGCTGAGCCTTA	ACTCCTRCGGGAGGCAGCAG	London.H.12
London.H.2	TTCGCGGATAGACCTA	ACTCCTRCGGGAGGCAGCAG	London.H.2
London.H.3	TTCGCGGAGTACTGAC	ACTCCTRCGGGAGGCAGCAG	London.H.3
London.H.4	TTCGCGGAGAGCCTTA	ACTCCTRCGGGAGGCAGCAG	London.H.4
London.H.5	GCGCGAGACTAAGCCT	ACTCCTRCGGGAGGCAGCAG	London.H.5
London.H.6	GCGCGAGATAGACCTA	ACTCCTRCGGGAGGCAGCAG	London.H.6
London.H.7	GCGCGAGAGTACTGAC	ACTCCTRCGGGAGGCAGCAG	London.H.7
London.H.8	GCGCGAGAGAGCCTTA	ACTCCTRCGGGAGGCAGCAG	London.H.8
London.H.9	CTATCGCTCTAAGCCT	ACTCCTRCGGGAGGCAGCAG	London.H.9
Miami.A.1	CCTGAGATTAGATCGC	ACTCCTRCGGGAGGCAGCAG	Miami.A.1
Miami.A.10	GTAGCTCCTGAACCTT	ACTCCTRCGGGAGGCAGCAG	Miami.A.10
Miami.A.11	GTAGCTCCTATAGCCT	ACTCCTRCGGGAGGCAGCAG	Miami.A.11
Miami.A.12	GTAGCTCCCGTCTAAT	ACTCCTRCGGGAGGCAGCAG	Miami.A.12
Miami.A.2	CCTGAGATTGAACCTT	ACTCCTRCGGGAGGCAGCAG	Miami.A.2
Miami.A.3	CCTGAGATTATAGCCT	ACTCCTRCGGGAGGCAGCAG	Miami.A.3
Miami.A.4	CCTGAGATCGTCTAAT	ACTCCTRCGGGAGGCAGCAG	Miami.A.4
Miami.A.5	TAGCGAGTTAGATCGC	ACTCCTRCGGGAGGCAGCAG	Miami.A.5
Miami.A.6	TAGCGAGTTGAACCTT	ACTCCTRCGGGAGGCAGCAG	Miami.A.6
Miami.A.7	TAGCGAGTTATAGCCT	ACTCCTRCGGGAGGCAGCAG	Miami.A.7
Miami.A.8	TAGCGAGTCGTCTAAT	ACTCCTRCGGGAGGCAGCAG	Miami.A.8
Miami.A.9	GTAGCTCCTAGATCGC	ACTCCTRCGGGAGGCAGCAG	Miami.A.9
Miami.B.1	CCTGAGATCTCTCTAT	ACTCCTRCGGGAGGCAGCAG	Miami.B.1
Miami.B.10	GTAGCTCCTGCTAAGT	ACTCCTRCGGGAGGCAGCAG	Miami.B.10
Miami.B.11	GTAGCTCCATAGAGGC	ACTCCTRCGGGAGGCAGCAG	Miami.B.11
Miami.B.12	GTAGCTCCTCTCTCCG	ACTCCTRCGGGAGGCAGCAG	Miami.B.12
Miami.B.2	CCTGAGATTGCTAAGT	ACTCCTRCGGGAGGCAGCAG	Miami.B.2
Miami.B.3	CCTGAGATATAGAGGC	ACTCCTRCGGGAGGCAGCAG	Miami.B.3
Miami.B.4	CCTGAGATTCTCTCCG	ACTCCTRCGGGAGGCAGCAG	Miami.B.4
Miami.B.5	TAGCGAGTCTCTCTAT	ACTCCTRCGGGAGGCAGCAG	Miami.B.5
Miami.B.6	TAGCGAGTTGCTAAGT	ACTCCTRCGGGAGGCAGCAG	Miami.B.6
Miami.B.7	TAGCGAGTATAGAGGC	ACTCCTRCGGGAGGCAGCAG	Miami.B.7
Miami.B.8	TAGCGAGTTCTCTCCG	ACTCCTRCGGGAGGCAGCAG	Miami.B.8
Miami.B.9	GTAGCTCCCTCTCTAT	ACTCCTRCGGGAGGCAGCAG	Miami.B.9
Miami.C.1	CCTGAGATTATCCTCT	ACTCCTRCGGGAGGCAGCAG	Miami.C.1
Miami.C.10	GTAGCTCCTGTTCTCT	ACTCCTRCGGGAGGCAGCAG	Miami.C.10
Miami.C.11	GTAGCTCCCCTATCCT	ACTCCTRCGGGAGGCAGCAG	Miami.C.11
Miami.C.12	GTAGCTCCTCGACTAG	ACTCCTRCGGGAGGCAGCAG	Miami.C.12
Miami.C.2	CCTGAGATTGTTCTCT	ACTCCTRCGGGAGGCAGCAG	Miami.C.2
Miami.C.3	CCTGAGATCCTATCCT	ACTCCTRCGGGAGGCAGCAG	Miami.C.3
Miami.C.4	CCTGAGATTCGACTAG	ACTCCTRCGGGAGGCAGCAG	Miami.C.4
Miami.C.5	TAGCGAGTTATCCTCT	ACTCCTRCGGGAGGCAGCAG	Miami.C.5
Miami.C.6	TAGCGAGTTGTTCTCT	ACTCCTRCGGGAGGCAGCAG	Miami.C.6
Miami.C.7	TAGCGAGTCCTATCCT	ACTCCTRCGGGAGGCAGCAG	Miami.C.7
Miami.C.8	TAGCGAGTTCGACTAG	ACTCCTRCGGGAGGCAGCAG	Miami.C.8
Miami.C.9	GTAGCTCCTATCCTCT	ACTCCTRCGGGAGGCAGCAG	Miami.C.9
Miami.D.1	CCTGAGATAGAGTAGA	ACTCCTRCGGGAGGCAGCAG	Miami.D.1
Miami.D.10	GTAGCTCCTAAGACAC	ACTCCTRCGGGAGGCAGCAG	Miami.D.10
Miami.D.11	GTAGCTCCGGCTCTGA	ACTCCTRCGGGAGGCAGCAG	Miami.D.11
Miami.D.12	GTAGCTCCTTCTAGCT	ACTCCTRCGGGAGGCAGCAG	Miami.D.12
Miami.D.2	CCTGAGATTAAGACAC	ACTCCTRCGGGAGGCAGCAG	Miami.D.2
Miami.D.3	CCTGAGATGGCTCTGA	ACTCCTRCGGGAGGCAGCAG	Miami.D.3
Miami.D.4	CCTGAGATTTCTAGCT	ACTCCTRCGGGAGGCAGCAG	Miami.D.4
Miami.D.5	TAGCGAGTAGAGTAGA	ACTCCTRCGGGAGGCAGCAG	Miami.D.5
Miami.D.6	TAGCGAGTTAAGACAC	ACTCCTRCGGGAGGCAGCAG	Miami.D.6
Miami.D.7	TAGCGAGTGGCTCTGA	ACTCCTRCGGGAGGCAGCAG	Miami.D.7
Miami.D.8	TAGCGAGTTTCTAGCT	ACTCCTRCGGGAGGCAGCAG	Miami.D.8
Miami.D.9	GTAGCTCCAGAGTAGA	ACTCCTRCGGGAGGCAGCAG	Miami.D.9
Miami.E.1	CCTGAGATGTAAGGAG	ACTCCTRCGGGAGGCAGCAG	Miami.E.1
Miami.E.10	GTAGCTCCCTAATCGA	ACTCCTRCGGGAGGCAGCAG	Miami.E.10
Miami.E.11	GTAGCTCCAGGCGAAG	ACTCCTRCGGGAGGCAGCAG	Miami.E.11
Miami.E.12	GTAGCTCCCCTAGAGT	ACTCCTRCGGGAGGCAGCAG	Miami.E.12
Miami.E.2	CCTGAGATCTAATCGA	ACTCCTRCGGGAGGCAGCAG	Miami.E.2
Miami.E.3	CCTGAGATAGGCGAAG	ACTCCTRCGGGAGGCAGCAG	Miami.E.3
Miami.E.4	CCTGAGATCCTAGAGT	ACTCCTRCGGGAGGCAGCAG	Miami.E.4
Miami.E.5	TAGCGAGTGTAAGGAG	ACTCCTRCGGGAGGCAGCAG	Miami.E.5
Miami.E.6	TAGCGAGTCTAATCGA	ACTCCTRCGGGAGGCAGCAG	Miami.E.6
Miami.E.7	TAGCGAGTAGGCGAAG	ACTCCTRCGGGAGGCAGCAG	Miami.E.7
Miami.E.8	TAGCGAGTCCTAGAGT	ACTCCTRCGGGAGGCAGCAG	Miami.E.8
Miami.E.9	GTAGCTCCGTAAGGAG	ACTCCTRCGGGAGGCAGCAG	Miami.E.9
Miami.F.1	CCTGAGATACTGCATA	ACTCCTRCGGGAGGCAGCAG	Miami.F.1
Miami.F.10	GTAGCTCCCTAGAACA	ACTCCTRCGGGAGGCAGCAG	Miami.F.10
Miami.F.11	GTAGCTCCTAATCTTA	ACTCCTRCGGGAGGCAGCAG	Miami.F.11
Miami.F.12	GTAGCTCCCTATTAAG	ACTCCTRCGGGAGGCAGCAG	Miami.F.12
Miami.F.2	CCTGAGATCTAGAACA	ACTCCTRCGGGAGGCAGCAG	Miami.F.2
Miami.F.3	CCTGAGATTAATCTTA	ACTCCTRCGGGAGGCAGCAG	Miami.F.3
Miami.F.4	CCTGAGATCTATTAAG	ACTCCTRCGGGAGGCAGCAG	Miami.F.4
Miami.F.5	TAGCGAGTACTGCATA	ACTCCTRCGGGAGGCAGCAG	Miami.F.5
Miami.F.6	TAGCGAGTCTAGAACA	ACTCCTRCGGGAGGCAGCAG	Miami.F.6
Miami.F.7	TAGCGAGTTAATCTTA	ACTCCTRCGGGAGGCAGCAG	Miami.F.7
Miami.F.8	TAGCGAGTCTATTAAG	ACTCCTRCGGGAGGCAGCAG	Miami.F.8
Miami.F.9	GTAGCTCCACTGCATA	ACTCCTRCGGGAGGCAGCAG	Miami.F.9
Miami.G.1	CCTGAGATAAGGAGTA	ACTCCTRCGGGAGGCAGCAG	Miami.G.1
Miami.G.10	GTAGCTCCTAAGTTCC	ACTCCTRCGGGAGGCAGCAG	Miami.G.10
Miami.G.11	GTAGCTCCCAGGACGT	ACTCCTRCGGGAGGCAGCAG	Miami.G.11
Miami.G.12	GTAGCTCCAAGGCTAT	ACTCCTRCGGGAGGCAGCAG	Miami.G.12
Miami.G.2	CCTGAGATTAAGTTCC	ACTCCTRCGGGAGGCAGCAG	Miami.G.2
Miami.G.3	CCTGAGATCAGGACGT	ACTCCTRCGGGAGGCAGCAG	Miami.G.3
Miami.G.4	CCTGAGATAAGGCTAT	ACTCCTRCGGGAGGCAGCAG	Miami.G.4
Miami.G.5	TAGCGAGTAAGGAGTA	ACTCCTRCGGGAGGCAGCAG	Miami.G.5
Miami.G.6	TAGCGAGTTAAGTTCC	ACTCCTRCGGGAGGCAGCAG	Miami.G.6
Miami.G.7	TAGCGAGTCAGGACGT	ACTCCTRCGGGAGGCAGCAG	Miami.G.7
Miami.G.8	TAGCGAGTAAGGCTAT	ACTCCTRCGGGAGGCAGCAG	Miami.G.8
Miami.G.9	GTAGCTCCAAGGAGTA	ACTCCTRCGGGAGGCAGCAG	Miami.G.9
Miami.H.1	CCTGAGATCTAAGCCT	ACTCCTRCGGGAGGCAGCAG	Miami.H.1
Miami.H.10	GTAGCTCCTAGACCTA	ACTCCTRCGGGAGGCAGCAG	Miami.H.10
Miami.H.11	GTAGCTCCGTACTGAC	ACTCCTRCGGGAGGCAGCAG	Miami.H.11
Miami.H.12	GTAGCTCCGAGCCTTA	ACTCCTRCGGGAGGCAGCAG	Miami.H.12
Miami.H.2	CCTGAGATTAGACCTA	ACTCCTRCGGGAGGCAGCAG	Miami.H.2
Miami.H.3	CCTGAGATGTACTGAC	ACTCCTRCGGGAGGCAGCAG	Miami.H.3
Miami.H.4	CCTGAGATGAGCCTTA	ACTCCTRCGGGAGGCAGCAG	Miami.H.4
Miami.H.5	TAGCGAGTCTAAGCCT	ACTCCTRCGGGAGGCAGCAG	Miami.H.5
Miami.H.6	TAGCGAGTTAGACCTA	ACTCCTRCGGGAGGCAGCAG	Miami.H.6
Miami.H.7	TAGCGAGTGTACTGAC	ACTCCTRCGGGAGGCAGCAG	Miami.H.7
Miami.H.8	TAGCGAGTGAGCCTTA	ACTCCTRCGGGAGGCAGCAG	Miami.H.8
Miami.H.9	GTAGCTCCCTAAGCCT	ACTCCTRCGGGAGGCAGCAG	Miami.H.9
Nairobi.A.1	TACTACGCTAGATCGC	ACTCCTRCGGGAGGCAGCAG	Nairobi.A.1
Nairobi.A.10	GCAGCGTATGAACCTT	ACTCCTRCGGGAGGCAGCAG	Nairobi.A.10
Nairobi.A.11	GCAGCGTATATAGCCT	ACTCCTRCGGGAGGCAGCAG	Nairobi.A.11
Nairobi.A.12	GCAGCGTACGTCTAAT	ACTCCTRCGGGAGGCAGCAG	Nairobi.A.12
Nairobi.A.2	TACTACGCTGAACCTT	ACTCCTRCGGGAGGCAGCAG	Nairobi.A.2
Nairobi.A.3	TACTACGCTATAGCCT	ACTCCTRCGGGAGGCAGCAG	Nairobi.A.3
Nairobi.A.4	TACTACGCCGTCTAAT	ACTCCTRCGGGAGGCAGCAG	Nairobi.A.4
Nairobi.A.5	AGGCTCCGTAGATCGC	ACTCCTRCGGGAGGCAGCAG	Nairobi.A.5
Nairobi.A.6	AGGCTCCGTGAACCTT	ACTCCTRCGGGAGGCAGCAG	Nairobi.A.6
Nairobi.A.7	AGGCTCCGTATAGCCT	ACTCCTRCGGGAGGCAGCAG	Nairobi.A.7
Nairobi.A.8	AGGCTCCGCGTCTAAT	ACTCCTRCGGGAGGCAGCAG	Nairobi.A.8
Nairobi.A.9	GCAGCGTATAGATCGC	ACTCCTRCGGGAGGCAGCAG	Nairobi.A.9
Nairobi.B.1	TACTACGCCTCTCTAT	ACTCCTRCGGGAGGCAGCAG	Nairobi.B.1
Nairobi.B.10	GCAGCGTATGCTAAGT	ACTCCTRCGGGAGGCAGCAG	Nairobi.B.10
Nairobi.B.11	GCAGCGTAATAGAGGC	ACTCCTRCGGGAGGCAGCAG	Nairobi.B.11
Nairobi.B.12	GCAGCGTATCTCTCCG	ACTCCTRCGGGAGGCAGCAG	Nairobi.B.12
Nairobi.B.2	TACTACGCTGCTAAGT	ACTCCTRCGGGAGGCAGCAG	Nairobi.B.2
Nairobi.B.3	TACTACGCATAGAGGC	ACTCCTRCGGGAGGCAGCAG	Nairobi.B.3
Nairobi.B.4	TACTACGCTCTCTCCG	ACTCCTRCGGGAGGCAGCAG	Nairobi.B.4
Nairobi.B.5	AGGCTCCGCTCTCTAT	ACTCCTRCGGGAGGCAGCAG	Nairobi.B.5
Nairobi.B.6	AGGCTCCGTGCTAAGT	ACTCCTRCGGGAGGCAGCAG	Nairobi.B.6
Nairobi.B.7	AGGCTCCGATAGAGGC	ACTCCTRCGGGAGGCAGCAG	Nairobi.B.7
Nairobi.B.8	AGGCTCCGTCTCTCCG	ACTCCTRCGGGAGGCAGCAG	Nairobi.B.8
Nairobi.B.9	GCAGCGTACTCTCTAT	ACTCCTRCGGGAGGCAGCAG	Nairobi.B.9
Nairobi.C.1	TACTACGCTATCCTCT	ACTCCTRCGGGAGGCAGCAG	Nairobi.C.1
Nairobi.C.10	GCAGCGTATGTTCTCT	ACTCCTRCGGGAGGCAGCAG	Nairobi.C.10
Nairobi.C.11	GCAGCGTACCTATCCT	ACTCCTRCGGGAGGCAGCAG	Nairobi.C.11
Nairobi.C.12	GCAGCGTATCGACTAG	ACTCCTRCGGGAGGCAGCAG	Nairobi.C.12
Nairobi.C.2	TACTACGCTGTTCTCT	ACTCCTRCGGGAGGCAGCAG	Nairobi.C.2
Nairobi.C.3	TACTACGCCCTATCCT	ACTCCTRCGGGAGGCAGCAG	Nairobi.C.3
Nairobi.C.4	TACTACGCTCGACTAG	ACTCCTRCGGGAGGCAGCAG	Nairobi.C.4
Nairobi.C.5	AGGCTCCGTATCCTCT	ACTCCTRCGGGAGGCAGCAG	Nairobi.C.5
Nairobi.C.6	AGGCTCCGTGTTCTCT	ACTCCTRCGGGAGGCAGCAG	Nairobi.C.6
Nairobi.C.7	AGGCTCCGCCTATCCT	ACTCCTRCGGGAGGCAGCAG	Nairobi.C.7
Nairobi.C.8	AGGCTCCGTCGACTAG	ACTCCTRCGGGAGGCAGCAG	Nairobi.C.8
Nairobi.C.9	GCAGCGTATATCCTCT	ACTCCTRCGGGAGGCAGCAG	Nairobi.C.9
Nairobi.D.1	TACTACGCAGAGTAGA	ACTCCTRCGGGAGGCAGCAG	Nairobi.D.1
Nairobi.D.10	GCAGCGTATAAGACAC	ACTCCTRCGGGAGGCAGCAG	Nairobi.D.10
Nairobi.D.11	GCAGCGTAGGCTCTGA	ACTCCTRCGGGAGGCAGCAG	Nairobi.D.11
Nairobi.D.12	GCAGCGTATTCTAGCT	ACTCCTRCGGGAGGCAGCAG	Nairobi.D.12
Nairobi.D.2	TACTACGCTAAGACAC	ACTCCTRCGGGAGGCAGCAG	Nairobi.D.2
Nairobi.D.3	TACTACGCGGCTCTGA	ACTCCTRCGGGAGGCAGCAG	Nairobi.D.3
Nairobi.D.4	TACTACGCTTCTAGCT	ACTCCTRCGGGAGGCAGCAG	Nairobi.D.4
Nairobi.D.5	AGGCTCCGAGAGTAGA	ACTCCTRCGGGAGGCAGCAG	Nairobi.D.5
Nairobi.D.6	AGGCTCCGTAAGACAC	ACTCCTRCGGGAGGCAGCAG	Nairobi.D.6
Nairobi.D.7	AGGCTCCGGGCTCTGA	ACTCCTRCGGGAGGCAGCAG	Nairobi.D.7
Nairobi.D.8	AGGCTCCGTTCTAGCT	ACTCCTRCGGGAGGCAGCAG	Nairobi.D.8
Nairobi.D.9	GCAGCGTAAGAGTAGA	ACTCCTRCGGGAGGCAGCAG	Nairobi.D.9
Nairobi.E.1	TACTACGCGTAAGGAG	ACTCCTRCGGGAGGCAGCAG	Nairobi.E.1
Nairobi.E.10	GCAGCGTACTAATCGA	ACTCCTRCGGGAGGCAGCAG	Nairobi.E.10
Nairobi.E.11	GCAGCGTAAGGCGAAG	ACTCCTRCGGGAGGCAGCAG	Nairobi.E.11
Nairobi.E.12	GCAGCGTACCTAGAGT	ACTCCTRCGGGAGGCAGCAG	Nairobi.E.12
Nairobi.E.2	TACTACGCCTAATCGA	ACTCCTRCGGGAGGCAGCAG	Nairobi.E.2
Nairobi.E.3	TACTACGCAGGCGAAG	ACTCCTRCGGGAGGCAGCAG	Nairobi.E.3
Nairobi.E.4	TACTACGCCCTAGAGT	ACTCCTRCGGGAGGCAGCAG	Nairobi.E.4
Nairobi.E.5	AGGCTCCGGTAAGGAG	ACTCCTRCGGGAGGCAGCAG	Nairobi.E.5
Nairobi.E.6	AGGCTCCGCTAATCGA	ACTCCTRCGGGAGGCAGCAG	Nairobi.E.6
Nairobi.E.7	AGGCTCCGAGGCGAAG	ACTCCTRCGGGAGGCAGCAG	Nairobi.E.7
Nairobi.E.8	AGGCTCCGCCTAGAGT	ACTCCTRCGGGAGGCAGCAG	Nairobi.E.8
Nairobi.E.9	GCAGCGTAGTAAGGAG	ACTCCTRCGGGAGGCAGCAG	Nairobi.E.9
Nairobi.F.1	TACTACGCACTGCATA	ACTCCTRCGGGAGGCAGCAG	Nairobi.F.1
Nairobi.F.10	GCAGCGTACTAGAACA	ACTCCTRCGGGAGGCAGCAG	Nairobi.F.10
Nairobi.F.11	GCAGCGTATAATCTTA	ACTCCTRCGGGAGGCAGCAG	Nairobi.F.11
Nairobi.F.12	GCAGCGTACTATTAAG	ACTCCTRCGGGAGGCAGCAG	Nairobi.F.12
Nairobi.F.2	TACTACGCCTAGAACA	ACTCCTRCGGGAGGCAGCAG	Nairobi.F.2
Nairobi.F.3	TACTACGCTAATCTTA	ACTCCTRCGGGAGGCAGCAG	Nairobi.F.3
Nairobi.F.4	TACTACGCCTATTAAG	ACTCCTRCGGGAGGCAGCAG	Nairobi.F.4
Nairobi.F.5	AGGCTCCGACTGCATA	ACTCCTRCGGGAGGCAGCAG	Nairobi.F.5
Nairobi.F.6	AGGCTCCGCTAGAACA	ACTCCTRCGGGAGGCAGCAG	Nairobi.F.6
Nairobi.F.7	AGGCTCCGTAATCTTA	ACTCCTRCGGGAGGCAGCAG	Nairobi.F.7
Nairobi.F.8	AGGCTCCGCTATTAAG	ACTCCTRCGGGAGGCAGCAG	Nairobi.F.8
Nairobi.F.9	GCAGCGTAACTGCATA	ACTCCTRCGGGAGGCAGCAG	Nairobi.F.9
Nairobi.G.1	TACTACGCAAGGAGTA	ACTCCTRCGGGAGGCAGCAG	Nairobi.G.1
Nairobi.G.10	GCAGCGTATAAGTTCC	ACTCCTRCGGGAGGCAGCAG	Nairobi.G.10
Nairobi.G.11	GCAGCGTACAGGACGT	ACTCCTRCGGGAGGCAGCAG	Nairobi.G.11
Nairobi.G.12	GCAGCGTAAAGGCTAT	ACTCCTRCGGGAGGCAGCAG	Nairobi.G.12
Nairobi.G.2	TACTACGCTAAGTTCC	ACTCCTRCGGGAGGCAGCAG	Nairobi.G.2
Nairobi.G.3	TACTACGCCAGGACGT	ACTCCTRCGGGAGGCAGCAG	Nairobi.G.3
Nairobi.G.4	TACTACGCAAGGCTAT	ACTCCTRCGGGAGGCAGCAG	Nairobi.G.4
Nairobi.G.5	AGGCTCCGAAGGAGTA	ACTCCTRCGGGAGGCAGCAG	Nairobi.G.5
Nairobi.G.6	AGGCTCCGTAAGTTCC	ACTCCTRCGGGAGGCAGCAG	Nairobi.G.6
Nairobi.G.7	AGGCTCCGCAGGACGT	ACTCCTRCGGGAGGCAGCAG	Nairobi.G.7
Nairobi.G.8	AGGCTCCGAAGGCTAT	ACTCCTRCGGGAGGCAGCAG	Nairobi.G.8
Nairobi.G.9	GCAGCGTAAAGGAGTA	ACTCCTRCGGGAGGCAGCAG	Nairobi.G.9
Nairobi.H.1	TACTACGCCTAAGCCT	ACTCCTRCGGGAGGCAGCAG	Nairobi.H.1
Nairobi.H.10	GCAGCGTATAGACCTA	ACTCCTRCGGGAGGCAGCAG	Nairobi.H.10
Nairobi.H.11	GCAGCGTAGTACTGAC	ACTCCTRCGGGAGGCAGCAG	Nairobi.H.11
Nairobi.H.12	GCAGCGTAGAGCCTTA	ACTCCTRCGGGAGGCAGCAG	Nairobi.H.12
Nairobi.H.2	TACTACGCTAGACCTA	ACTCCTRCGGGAGGCAGCAG	Nairobi.H.2
Nairobi.H.3	TACTACGCGTACTGAC	ACTCCTRCGGGAGGCAGCAG	Nairobi.H.3
Nairobi.H.4	TACTACGCGAGCCTTA	ACTCCTRCGGGAGGCAGCAG	Nairobi.H.4
Nairobi.H.5	AGGCTCCGCTAAGCCT	ACTCCTRCGGGAGGCAGCAG	Nairobi.H.5
Nairobi.H.6	AGGCTCCGTAGACCTA	ACTCCTRCGGGAGGCAGCAG	Nairobi.H.6
Nairobi.H.7	AGGCTCCGGTACTGAC	ACTCCTRCGGGAGGCAGCAG	Nairobi.H.7
Nairobi.H.8	AGGCTCCGGAGCCTTA	ACTCCTRCGGGAGGCAGCAG	Nairobi.H.8
Nairobi.H.9	GCAGCGTACTAAGCCT	ACTCCTRCGGGAGGCAGCAG	Nairobi.H.9
Odessa.A.1	CTGCGCATTAGATCGC	ACTCCTRCGGGAGGCAGCAG	Odessa.A.1
Odessa.A.10	CGCTCAGTTGAACCTT	ACTCCTRCGGGAGGCAGCAG	Odessa.A.10
Odessa.A.11	CGCTCAGTTATAGCCT	ACTCCTRCGGGAGGCAGCAG	Odessa.A.11
Odessa.A.12	CGCTCAGTCGTCTAAT	ACTCCTRCGGGAGGCAGCAG	Odessa.A.12
Odessa.A.2	CTGCGCATTGAACCTT	ACTCCTRCGGGAGGCAGCAG	Odessa.A.2
Odessa.A.3	CTGCGCATTATAGCCT	ACTCCTRCGGGAGGCAGCAG	Odessa.A.3
Odessa.A.4	CTGCGCATCGTCTAAT	ACTCCTRCGGGAGGCAGCAG	Odessa.A.4
Odessa.A.5	GAGCGCTATAGATCGC	ACTCCTRCGGGAGGCAGCAG	Odessa.A.5
Odessa.A.6	GAGCGCTATGAACCTT	ACTCCTRCGGGAGGCAGCAG	Odessa.A.6
Odessa.A.7	GAGCGCTATATAGCCT	ACTCCTRCGGGAGGCAGCAG	Odessa.A.7
Odessa.A.8	GAGCGCTACGTCTAAT	ACTCCTRCGGGAGGCAGCAG	Odessa.A.8
Odessa.A.9	CGCTCAGTTAGATCGC	ACTCCTRCGGGAGGCAGCAG	Odessa.A.9
Odessa.B.1	CTGCGCATCTCTCTAT	ACTCCTRCGGGAGGCAGCAG	Odessa.B.1
Odessa.B.10	CGCTCAGTTGCTAAGT	ACTCCTRCGGGAGGCAGCAG	Odessa.B.10
Odessa.B.11	CGCTCAGTATAGAGGC	ACTCCTRCGGGAGGCAGCAG	Odessa.B.11
Odessa.B.12	CGCTCAGTTCTCTCCG	ACTCCTRCGGGAGGCAGCAG	Odessa.B.12
Odessa.B.2	CTGCGCATTGCTAAGT	ACTCCTRCGGGAGGCAGCAG	Odessa.B.2
Odessa.B.3	CTGCGCATATAGAGGC	ACTCCTRCGGGAGGCAGCAG	Odessa.B.3
Odessa.B.4	CTGCGCATTCTCTCCG	ACTCCTRCGGGAGGCAGCAG	Odessa.B.4
Odessa.B.5	GAGCGCTACTCTCTAT	ACTCCTRCGGGAGGCAGCAG	Odessa.B.5
Odessa.B.6	GAGCGCTATGCTAAGT	ACTCCTRCGGGAGGCAGCAG	Odessa.B.6
Odessa.B.7	GAGCGCTAATAGAGGC	ACTCCTRCGGGAGGCAGCAG	Odessa.B.7
Odessa.B.8	GAGCGCTATCTCTCCG	ACTCCTRCGGGAGGCAGCAG	Odessa.B.8
Odessa.B.9	CGCTCAGTCTCTCTAT	ACTCCTRCGGGAGGCAGCAG	Odessa.B.9
Odessa.C.1	CTGCGCATTATCCTCT	ACTCCTRCGGGAGGCAGCAG	Odessa.C.1
Odessa.C.10	CGCTCAGTTGTTCTCT	ACTCCTRCGGGAGGCAGCAG	Odessa.C.10
Odessa.C.11	CGCTCAGTCCTATCCT	ACTCCTRCGGGAGGCAGCAG	Odessa.C.11
Odessa.C.12	CGCTCAGTTCGACTAG	ACTCCTRCGGGAGGCAGCAG	Odessa.C.12
Odessa.C.2	CTGCGCATTGTTCTCT	ACTCCTRCGGGAGGCAGCAG	Odessa.C.2
Odessa.C.3	CTGCGCATCCTATCCT	ACTCCTRCGGGAGGCAGCAG	Odessa.C.3
Odessa.C.4	CTGCGCATTCGACTAG	ACTCCTRCGGGAGGCAGCAG	Odessa.C.4
Odessa.C.5	GAGCGCTATATCCTCT	ACTCCTRCGGGAGGCAGCAG	Odessa.C.5
Odessa.C.6	GAGCGCTATGTTCTCT	ACTCCTRCGGGAGGCAGCAG	Odessa.C.6
Odessa.C.7	GAGCGCTACCTATCCT	ACTCCTRCGGGAGGCAGCAG	Odessa.C.7
Odessa.C.8	GAGCGCTATCGACTAG	ACTCCTRCGGGAGGCAGCAG	Odessa.C.8
Odessa.C.9	CGCTCAGTTATCCTCT	ACTCCTRCGGGAGGCAGCAG	Odessa.C.9
Odessa.D.1	CTGCGCATAGAGTAGA	ACTCCTRCGGGAGGCAGCAG	Odessa.D.1
Odessa.D.10	CGCTCAGTTAAGACAC	ACTCCTRCGGGAGGCAGCAG	Odessa.D.10
Odessa.D.11	CGCTCAGTGGCTCTGA	ACTCCTRCGGGAGGCAGCAG	Odessa.D.11
Odessa.D.12	CGCTCAGTTTCTAGCT	ACTCCTRCGGGAGGCAGCAG	Odessa.D.12
Odessa.D.2	CTGCGCATTAAGACAC	ACTCCTRCGGGAGGCAGCAG	Odessa.D.2
Odessa.D.3	CTGCGCATGGCTCTGA	ACTCCTRCGGGAGGCAGCAG	Odessa.D.3
Odessa.D.4	CTGCGCATTTCTAGCT	ACTCCTRCGGGAGGCAGCAG	Odessa.D.4
Odessa.D.5	GAGCGCTAAGAGTAGA	ACTCCTRCGGGAGGCAGCAG	Odessa.D.5
Odessa.D.6	GAGCGCTATAAGACAC	ACTCCTRCGGGAGGCAGCAG	Odessa.D.6
Odessa.D.7	GAGCGCTAGGCTCTGA	ACTCCTRCGGGAGGCAGCAG	Odessa.D.7
Odessa.D.8	GAGCGCTATTCTAGCT	ACTCCTRCGGGAGGCAGCAG	Odessa.D.8
Odessa.D.9	CGCTCAGTAGAGTAGA	ACTCCTRCGGGAGGCAGCAG	Odessa.D.9
Odessa.E.1	CTGCGCATGTAAGGAG	ACTCCTRCGGGAGGCAGCAG	Odessa.E.1
Odessa.E.10	CGCTCAGTCTAATCGA	ACTCCTRCGGGAGGCAGCAG	Odessa.E.10
Odessa.E.11	CGCTCAGTAGGCGAAG	ACTCCTRCGGGAGGCAGCAG	Odessa.E.11
Odessa.E.12	CGCTCAGTCCTAGAGT	ACTCCTRCGGGAGGCAGCAG	Odessa.E.12
Odessa.E.2	CTGCGCATCTAATCGA	ACTCCTRCGGGAGGCAGCAG	Odessa.E.2
Odessa.E.3	CTGCGCATAGGCGAAG	ACTCCTRCGGGAGGCAGCAG	Odessa.E.3
Odessa.E.4	CTGCGCATCCTAGAGT	ACTCCTRCGGGAGGCAGCAG	Odessa.E.4
Odessa.E.5	GAGCGCTAGTAAGGAG	ACTCCTRCGGGAGGCAGCAG	Odessa.E.5
Odessa.E.6	GAGCGCTACTAATCGA	ACTCCTRCGGGAGGCAGCAG	Odessa.E.6
Odessa.E.7	GAGCGCTAAGGCGAAG	ACTCCTRCGGGAGGCAGCAG	Odessa.E.7
Odessa.E.8	GAGCGCTACCTAGAGT	ACTCCTRCGGGAGGCAGCAG	Odessa.E.8
Odessa.E.9	CGCTCAGTGTAAGGAG	ACTCCTRCGGGAGGCAGCAG	Odessa.E.9
Odessa.F.1	CTGCGCATACTGCATA	ACTCCTRCGGGAGGCAGCAG	Odessa.F.1
Odessa.F.10	CGCTCAGTCTAGAACA	ACTCCTRCGGGAGGCAGCAG	Odessa.F.10
Odessa.F.11	CGCTCAGTTAATCTTA	ACTCCTRCGGGAGGCAGCAG	Odessa.F.11
Odessa.F.12	CGCTCAGTCTATTAAG	ACTCCTRCGGGAGGCAGCAG	Odessa.F.12
Odessa.F.2	CTGCGCATCTAGAACA	ACTCCTRCGGGAGGCAGCAG	Odessa.F.2
Odessa.F.3	CTGCGCATTAATCTTA	ACTCCTRCGGGAGGCAGCAG	Odessa.F.3
Odessa.F.4	CTGCGCATCTATTAAG	ACTCCTRCGGGAGGCAGCAG	Odessa.F.4
Odessa.F.5	GAGCGCTAACTGCATA	ACTCCTRCGGGAGGCAGCAG	Odessa.F.5
Odessa.F.6	GAGCGCTACTAGAACA	ACTCCTRCGGGAGGCAGCAG	Odessa.F.6
Odessa.F.7	GAGCGCTATAATCTTA	ACTCCTRCGGGAGGCAGCAG	Odessa.F.7
Odessa.F.8	GAGCGCTACTATTAAG	ACTCCTRCGGGAGGCAGCAG	Odessa.F.8
Odessa.F.9	CGCTCAGTACTGCATA	ACTCCTRCGGGAGGCAGCAG	Odessa.F.9
Odessa.G.1	CTGCGCATAAGGAGTA	ACTCCTRCGGGAGGCAGCAG	Odessa.G.1
Odessa.G.10	CGCTCAGTTAAGTTCC	ACTCCTRCGGGAGGCAGCAG	Odessa.G.10
Odessa.G.11	CGCTCAGTCAGGACGT	ACTCCTRCGGGAGGCAGCAG	Odessa.G.11
Odessa.G.12	CGCTCAGTAAGGCTAT	ACTCCTRCGGGAGGCAGCAG	Odessa.G.12
Odessa.G.2	CTGCGCATTAAGTTCC	ACTCCTRCGGGAGGCAGCAG	Odessa.G.2
Odessa.G.3	CTGCGCATCAGGACGT	ACTCCTRCGGGAGGCAGCAG	Odessa.G.3
Odessa.G.4	CTGCGCATAAGGCTAT	ACTCCTRCGGGAGGCAGCAG	Odessa.G.4
Odessa.G.5	GAGCGCTAAAGGAGTA	ACTCCTRCGGGAGGCAGCAG	Odessa.G.5
Odessa.G.6	GAGCGCTATAAGTTCC	ACTCCTRCGGGAGGCAGCAG	Odessa.G.6
Odessa.G.7	GAGCGCTACAGGACGT	ACTCCTRCGGGAGGCAGCAG	Odessa.G.7
Odessa.G.8	GAGCGCTAAAGGCTAT	ACTCCTRCGGGAGGCAGCAG	Odessa.G.8
Odessa.G.9	CGCTCAGTAAGGAGTA	ACTCCTRCGGGAGGCAGCAG	Odessa.G.9
Odessa.H.1	CTGCGCATCTAAGCCT	ACTCCTRCGGGAGGCAGCAG	Odessa.H.1
Odessa.H.10	CGCTCAGTTAGACCTA	ACTCCTRCGGGAGGCAGCAG	Odessa.H.10
Odessa.H.11	CGCTCAGTGTACTGAC	ACTCCTRCGGGAGGCAGCAG	Odessa.H.11
Odessa.H.12	CGCTCAGTGAGCCTTA	ACTCCTRCGGGAGGCAGCAG	Odessa.H.12
Odessa.H.2	CTGCGCATTAGACCTA	ACTCCTRCGGGAGGCAGCAG	Odessa.H.2
Odessa.H.3	CTGCGCATGTACTGAC	ACTCCTRCGGGAGGCAGCAG	Odessa.H.3
Odessa.H.4	CTGCGCATGAGCCTTA	ACTCCTRCGGGAGGCAGCAG	Odessa.H.4
Odessa.H.5	GAGCGCTACTAAGCCT	ACTCCTRCGGGAGGCAGCAG	Odessa.H.5
Odessa.H.6	GAGCGCTATAGACCTA	ACTCCTRCGGGAGGCAGCAG	Odessa.H.6
Odessa.H.7	GAGCGCTAGTACTGAC	ACTCCTRCGGGAGGCAGCAG	Odessa.H.7
Odessa.H.8	GAGCGCTAGAGCCTTA	ACTCCTRCGGGAGGCAGCAG	Odessa.H.8
Odessa.H.9	CGCTCAGTCTAAGCCT	ACTCCTRCGGGAGGCAGCAG	Odessa.H.9
Paris.A.1	GTCTTAGGTAGATCGC	ACTCCTRCGGGAGGCAGCAG	Paris.A.1
Paris.A.10	TAGCTGCATGAACCTT	ACTCCTRCGGGAGGCAGCAG	Paris.A.10
Paris.A.11	TAGCTGCATATAGCCT	ACTCCTRCGGGAGGCAGCAG	Paris.A.11
Paris.A.12	TAGCTGCACGTCTAAT	ACTCCTRCGGGAGGCAGCAG	Paris.A.12
Paris.A.2	GTCTTAGGTGAACCTT	ACTCCTRCGGGAGGCAGCAG	Paris.A.2
Paris.A.3	GTCTTAGGTATAGCCT	ACTCCTRCGGGAGGCAGCAG	Paris.A.3
Paris.A.4	GTCTTAGGCGTCTAAT	ACTCCTRCGGGAGGCAGCAG	Paris.A.4
Paris.A.5	ACTGATCGTAGATCGC	ACTCCTRCGGGAGGCAGCAG	Paris.A.5
Paris.A.6	ACTGATCGTGAACCTT	ACTCCTRCGGGAGGCAGCAG	Paris.A.6
Paris.A.7	ACTGATCGTATAGCCT	ACTCCTRCGGGAGGCAGCAG	Paris.A.7
Paris.A.8	ACTGATCGCGTCTAAT	ACTCCTRCGGGAGGCAGCAG	Paris.A.8
Paris.A.9	TAGCTGCATAGATCGC	ACTCCTRCGGGAGGCAGCAG	Paris.A.9
Paris.B.1	GTCTTAGGCTCTCTAT	ACTCCTRCGGGAGGCAGCAG	Paris.B.1
Paris.B.10	TAGCTGCATGCTAAGT	ACTCCTRCGGGAGGCAGCAG	Paris.B.10
Paris.B.11	TAGCTGCAATAGAGGC	ACTCCTRCGGGAGGCAGCAG	Paris.B.11
Paris.B.12	TAGCTGCATCTCTCCG	ACTCCTRCGGGAGGCAGCAG	Paris.B.12
Paris.B.2	GTCTTAGGTGCTAAGT	ACTCCTRCGGGAGGCAGCAG	Paris.B.2
Paris.B.3	GTCTTAGGATAGAGGC	ACTCCTRCGGGAGGCAGCAG	Paris.B.3
Paris.B.4	GTCTTAGGTCTCTCCG	ACTCCTRCGGGAGGCAGCAG	Paris.B.4
Paris.B.5	ACTGATCGCTCTCTAT	ACTCCTRCGGGAGGCAGCAG	Paris.B.5
Paris.B.6	ACTGATCGTGCTAAGT	ACTCCTRCGGGAGGCAGCAG	Paris.B.6
Paris.B.7	ACTGATCGATAGAGGC	ACTCCTRCGGGAGGCAGCAG	Paris.B.7
Paris.B.8	ACTGATCGTCTCTCCG	ACTCCTRCGGGAGGCAGCAG	Paris.B.8
Paris.B.9	TAGCTGCACTCTCTAT	ACTCCTRCGGGAGGCAGCAG	Paris.B.9
Paris.C.1	GTCTTAGGTATCCTCT	ACTCCTRCGGGAGGCAGCAG	Paris.C.1
Paris.C.10	TAGCTGCATGTTCTCT	ACTCCTRCGGGAGGCAGCAG	Paris.C.10
Paris.C.11	TAGCTGCACCTATCCT	ACTCCTRCGGGAGGCAGCAG	Paris.C.11
Paris.C.12	TAGCTGCATCGACTAG	ACTCCTRCGGGAGGCAGCAG	Paris.C.12
Paris.C.2	GTCTTAGGTGTTCTCT	ACTCCTRCGGGAGGCAGCAG	Paris.C.2
Paris.C.3	GTCTTAGGCCTATCCT	ACTCCTRCGGGAGGCAGCAG	Paris.C.3
Paris.C.4	GTCTTAGGTCGACTAG	ACTCCTRCGGGAGGCAGCAG	Paris.C.4
Paris.C.5	ACTGATCGTATCCTCT	ACTCCTRCGGGAGGCAGCAG	Paris.C.5
Paris.C.6	ACTGATCGTGTTCTCT	ACTCCTRCGGGAGGCAGCAG	Paris.C.6
Paris.C.7	ACTGATCGCCTATCCT	ACTCCTRCGGGAGGCAGCAG	Paris.C.7
Paris.C.8	ACTGATCGTCGACTAG	ACTCCTRCGGGAGGCAGCAG	Paris.C.8
Paris.C.9	TAGCTGCATATCCTCT	ACTCCTRCGGGAGGCAGCAG	Paris.C.9
Paris.D.1	GTCTTAGGAGAGTAGA	ACTCCTRCGGGAGGCAGCAG	Paris.D.1
Paris.D.10	TAGCTGCATAAGACAC	ACTCCTRCGGGAGGCAGCAG	Paris.D.10
Paris.D.11	TAGCTGCAGGCTCTGA	ACTCCTRCGGGAGGCAGCAG	Paris.D.11
Paris.D.12	TAGCTGCATTCTAGCT	ACTCCTRCGGGAGGCAGCAG	Paris.D.12
Paris.D.2	GTCTTAGGTAAGACAC	ACTCCTRCGGGAGGCAGCAG	Paris.D.2
Paris.D.3	GTCTTAGGGGCTCTGA	ACTCCTRCGGGAGGCAGCAG	Paris.D.3
Paris.D.4	GTCTTAGGTTCTAGCT	ACTCCTRCGGGAGGCAGCAG	Paris.D.4
Paris.D.5	ACTGATCGAGAGTAGA	ACTCCTRCGGGAGGCAGCAG	Paris.D.5
Paris.D.6	ACTGATCGTAAGACAC	ACTCCTRCGGGAGGCAGCAG	Paris.D.6
Paris.D.7	ACTGATCGGGCTCTGA	ACTCCTRCGGGAGGCAGCAG	Paris.D.7
Paris.D.8	ACTGATCGTTCTAGCT	ACTCCTRCGGGAGGCAGCAG	Paris.D.8
Paris.D.9	TAGCTGCAAGAGTAGA	ACTCCTRCGGGAGGCAGCAG	Paris.D.9
Paris.E.1	GTCTTAGGGTAAGGAG	ACTCCTRCGGGAGGCAGCAG	Paris.E.1
Paris.E.10	TAGCTGCACTAATCGA	ACTCCTRCGGGAGGCAGCAG	Paris.E.10
Paris.E.11	TAGCTGCAAGGCGAAG	ACTCCTRCGGGAGGCAGCAG	Paris.E.11
Paris.E.12	TAGCTGCACCTAGAGT	ACTCCTRCGGGAGGCAGCAG	Paris.E.12
Paris.E.2	GTCTTAGGCTAATCGA	ACTCCTRCGGGAGGCAGCAG	Paris.E.2
Paris.E.3	GTCTTAGGAGGCGAAG	ACTCCTRCGGGAGGCAGCAG	Paris.E.3
Paris.E.4	GTCTTAGGCCTAGAGT	ACTCCTRCGGGAGGCAGCAG	Paris.E.4
Paris.E.5	ACTGATCGGTAAGGAG	ACTCCTRCGGGAGGCAGCAG	Paris.E.5
Paris.E.6	ACTGATCGCTAATCGA	ACTCCTRCGGGAGGCAGCAG	Paris.E.6
Paris.E.7	ACTGATCGAGGCGAAG	ACTCCTRCGGGAGGCAGCAG	Paris.E.7
Paris.E.8	ACTGATCGCCTAGAGT	ACTCCTRCGGGAGGCAGCAG	Paris.E.8
Paris.E.9	TAGCTGCAGTAAGGAG	ACTCCTRCGGGAGGCAGCAG	Paris.E.9
Paris.F.1	GTCTTAGGACTGCATA	ACTCCTRCGGGAGGCAGCAG	Paris.F.1
Paris.F.10	TAGCTGCACTAGAACA	ACTCCTRCGGGAGGCAGCAG	Paris.F.10
Paris.F.11	TAGCTGCATAATCTTA	ACTCCTRCGGGAGGCAGCAG	Paris.F.11
Paris.F.12	TAGCTGCACTATTAAG	ACTCCTRCGGGAGGCAGCAG	Paris.F.12
Paris.F.2	GTCTTAGGCTAGAACA	ACTCCTRCGGGAGGCAGCAG	Paris.F.2
Paris.F.3	GTCTTAGGTAATCTTA	ACTCCTRCGGGAGGCAGCAG	Paris.F.3
Paris.F.4	GTCTTAGGCTATTAAG	ACTCCTRCGGGAGGCAGCAG	Paris.F.4
Paris.F.5	ACTGATCGACTGCATA	ACTCCTRCGGGAGGCAGCAG	Paris.F.5
Paris.F.6	ACTGATCGCTAGAACA	ACTCCTRCGGGAGGCAGCAG	Paris.F.6
Paris.F.7	ACTGATCGTAATCTTA	ACTCCTRCGGGAGGCAGCAG	Paris.F.7
Paris.F.8	ACTGATCGCTATTAAG	ACTCCTRCGGGAGGCAGCAG	Paris.F.8
Paris.F.9	TAGCTGCAACTGCATA	ACTCCTRCGGGAGGCAGCAG	Paris.F.9
Paris.G.1	GTCTTAGGAAGGAGTA	ACTCCTRCGGGAGGCAGCAG	Paris.G.1
Paris.G.10	TAGCTGCATAAGTTCC	ACTCCTRCGGGAGGCAGCAG	Paris.G.10
Paris.G.11	TAGCTGCACAGGACGT	ACTCCTRCGGGAGGCAGCAG	Paris.G.11
Paris.G.12	TAGCTGCAAAGGCTAT	ACTCCTRCGGGAGGCAGCAG	Paris.G.12
Paris.G.2	GTCTTAGGTAAGTTCC	ACTCCTRCGGGAGGCAGCAG	Paris.G.2
Paris.G.3	GTCTTAGGCAGGACGT	ACTCCTRCGGGAGGCAGCAG	Paris.G.3
Paris.G.4	GTCTTAGGAAGGCTAT	ACTCCTRCGGGAGGCAGCAG	Paris.G.4
Paris.G.5	ACTGATCGAAGGAGTA	ACTCCTRCGGGAGGCAGCAG	Paris.G.5
Paris.G.6	ACTGATCGTAAGTTCC	ACTCCTRCGGGAGGCAGCAG	Paris.G.6
Paris.G.7	ACTGATCGCAGGACGT	ACTCCTRCGGGAGGCAGCAG	Paris.G.7
Paris.G.8	ACTGATCGAAGGCTAT	ACTCCTRCGGGAGGCAGCAG	Paris.G.8
Paris.G.9	TAGCTGCAAAGGAGTA	ACTCCTRCGGGAGGCAGCAG	Paris.G.9
Paris.H.1	GTCTTAGGCTAAGCCT	ACTCCTRCGGGAGGCAGCAG	Paris.H.1
Paris.H.10	TAGCTGCATAGACCTA	ACTCCTRCGGGAGGCAGCAG	Paris.H.10
Paris.H.11	TAGCTGCAGTACTGAC	ACTCCTRCGGGAGGCAGCAG	Paris.H.11
Paris.H.12	TAGCTGCAGAGCCTTA	ACTCCTRCGGGAGGCAGCAG	Paris.H.12
Paris.H.2	GTCTTAGGTAGACCTA	ACTCCTRCGGGAGGCAGCAG	Paris.H.2
Paris.H.3	GTCTTAGGGTACTGAC	ACTCCTRCGGGAGGCAGCAG	Paris.H.3
Paris.H.4	GTCTTAGGGAGCCTTA	ACTCCTRCGGGAGGCAGCAG	Paris.H.4
Paris.H.5	ACTGATCGCTAAGCCT	ACTCCTRCGGGAGGCAGCAG	Paris.H.5
Paris.H.6	ACTGATCGTAGACCTA	ACTCCTRCGGGAGGCAGCAG	Paris.H.6
Paris.H.7	ACTGATCGGTACTGAC	ACTCCTRCGGGAGGCAGCAG	Paris.H.7
Paris.H.8	ACTGATCGGAGCCTTA	ACTCCTRCGGGAGGCAGCAG	Paris.H.8
Paris.H.9	TAGCTGCACTAAGCCT	ACTCCTRCGGGAGGCAGCAG	Paris.H.9
Quebec.A.1	GACGTCGATAGATCGC	ACTCCTRCGGGAGGCAGCAG	Quebec.A.1
Quebec.A.2	GACGTCGATGAACCTT	ACTCCTRCGGGAGGCAGCAG	Quebec.A.2
Quebec.A.3	GACGTCGATATAGCCT	ACTCCTRCGGGAGGCAGCAG	Quebec.A.3
Quebec.A.4	GACGTCGACGTCTAAT	ACTCCTRCGGGAGGCAGCAG	Quebec.A.4
Quebec.B.1	GACGTCGACTCTCTAT	ACTCCTRCGGGAGGCAGCAG	Quebec.B.1
Quebec.B.2	GACGTCGATGCTAAGT	ACTCCTRCGGGAGGCAGCAG	Quebec.B.2
Quebec.B.3	GACGTCGAATAGAGGC	ACTCCTRCGGGAGGCAGCAG	Quebec.B.3
Quebec.B.4	GACGTCGATCTCTCCG	ACTCCTRCGGGAGGCAGCAG	Quebec.B.4
Quebec.C.1	GACGTCGATATCCTCT	ACTCCTRCGGGAGGCAGCAG	Quebec.C.1
Quebec.C.2	GACGTCGATGTTCTCT	ACTCCTRCGGGAGGCAGCAG	Quebec.C.2
Quebec.C.3	GACGTCGACCTATCCT	ACTCCTRCGGGAGGCAGCAG	Quebec.C.3
Quebec.C.4	GACGTCGATCGACTAG	ACTCCTRCGGGAGGCAGCAG	Quebec.C.4
Quebec.D.1	GACGTCGAAGAGTAGA	ACTCCTRCGGGAGGCAGCAG	Quebec.D.1
Quebec.D.2	GACGTCGATAAGACAC	ACTCCTRCGGGAGGCAGCAG	Quebec.D.2
Quebec.D.3	GACGTCGAGGCTCTGA	ACTCCTRCGGGAGGCAGCAG	Quebec.D.3
Quebec.D.4	GACGTCGATTCTAGCT	ACTCCTRCGGGAGGCAGCAG	Quebec.D.4
Quebec.E.1	GACGTCGAGTAAGGAG	ACTCCTRCGGGAGGCAGCAG	Quebec.E.1
Quebec.E.2	GACGTCGACTAATCGA	ACTCCTRCGGGAGGCAGCAG	Quebec.E.2
Quebec.E.3	GACGTCGAAGGCGAAG	ACTCCTRCGGGAGGCAGCAG	Quebec.E.3
Quebec.E.4	GACGTCGACCTAGAGT	ACTCCTRCGGGAGGCAGCAG	Quebec.E.4
Quebec.F.1	GACGTCGAACTGCATA	ACTCCTRCGGGAGGCAGCAG	Quebec.F.1
Quebec.F.2	GACGTCGACTAGAACA	ACTCCTRCGGGAGGCAGCAG	Quebec.F.2
Quebec.F.3	GACGTCGATAATCTTA	ACTCCTRCGGGAGGCAGCAG	Quebec.F.3
Quebec.F.4	GACGTCGACTATTAAG	ACTCCTRCGGGAGGCAGCAG	Quebec.F.4
Quebec.G.1	GACGTCGAAAGGAGTA	ACTCCTRCGGGAGGCAGCAG	Quebec.G.1
Quebec.G.2	GACGTCGATAAGTTCC	ACTCCTRCGGGAGGCAGCAG	Quebec.G.2
Quebec.G.3	GACGTCGACAGGACGT	ACTCCTRCGGGAGGCAGCAG	Quebec.G.3
Quebec.G.4	GACGTCGAAAGGCTAT	ACTCCTRCGGGAGGCAGCAG	Quebec.G.4
Quebec.H.1	GACGTCGACTAAGCCT	ACTCCTRCGGGAGGCAGCAG	Quebec.H.1
Quebec.H.2	GACGTCGATAGACCTA	ACTCCTRCGGGAGGCAGCAG	Quebec.H.2
Quebec.H.3	GACGTCGAGTACTGAC	ACTCCTRCGGGAGGCAGCAG	Quebec.H.3
Quebec.H.4	GACGTCGAGAGCCTTA	ACTCCTRCGGGAGGCAGCAG	Quebec.H.4